Date,State_Name,SL_No,District_Name,HH_PER-BASE_TOTAL,HH_PER-BASE_SC,HH_PER-BASE_ST,BPL_WT,BPL_WOT,APL_WT,APL_WOT,APL+BPL_WT,APL+BPL_WOT,SCH_WT,SCH_WOT,ANGAN_WT,ANGAN_WOT,SAN_WT,SAN_WOT
3/15/2013,ANDHRA PRADESH,1,ADILABAD,406468,77928,72158,13312,261726,4528,126578,17840,388304,324,1015,121,306,0,0
3/15/2013,ANDHRA PRADESH,2,ANANTAPUR,715128,68153,22310,274192,246023,101502,93411,375694,339434,2233,622,243,283,8,0
3/15/2013,ANDHRA PRADESH,3,CHITTOOR,605121,156660,37265,190200,295716,73042,46163,263242,341879,2786,1899,308,361,0,0
3/15/2013,ANDHRA PRADESH,4,CUDDAPAH,467792,90250,18600,166663,251494,23065,26570,189728,278064,2913,1732,403,238,0,0
3/15/2013,ANDHRA PRADESH,5,EAST GODAVARI,1066661,215894,47999,219974,303755,393587,149345,613561,453100,1736,2117,771,931,6,42
3/15/2013,ANDHRA PRADESH,6,GUNTUR,782238,155032,39795,180184,367363,94379,140312,274563,507675,2508,1173,300,214,1,0
3/15/2013,ANDHRA PRADESH,7,KARIMNAGAR,689887,132072,24393,71358,311460,172056,135013,243414,446473,749,2314,285,271,0,0
3/15/2013,ANDHRA PRADESH,8,KHAMMAM,554816,100518,161491,264529,183431,102794,4171,367323,187602,3112,39,787,428,1,0
3/15/2013,ANDHRA PRADESH,9,KRISHNA,751132,154600,25810,67505,351572,238669,93386,306174,444958,1525,3374,429,62,0,1
3/15/2013,ANDHRA PRADESH,10,KURNOOL,588903,118755,13540,113630,312183,35046,128044,148676,440227,1493,918,0,421,19,0
3/15/2013,ANDHRA PRADESH,11,MAHBUBNAGAR,622104,71884,112368,116109,415718,40090,50187,156199,465905,1460,1136,38,124,0,0
3/15/2013,ANDHRA PRADESH,12,MEDAK,439672,101701,30220,93949,311743,22094,11886,116043,323629,1766,1063,375,940,2,0
3/15/2013,ANDHRA PRADESH,13,NALGONDA,599022,40875,14035,151076,214790,103578,129578,254654,344368,1915,1368,588,43,0,0
3/15/2013,ANDHRA PRADESH,14,NELLORE,462284,117945,58015,88440,226725,35594,111525,124034,338250,2747,340,559,362,3,0
3/15/2013,ANDHRA PRADESH,15,NIZAMABAD,477685,57733,15834,123201,225519,119491,9474,242692,234993,1039,1438,401,32,0,0
3/15/2013,ANDHRA PRADESH,16,PRAKASAM,687083,136917,25639,76962,252004,206763,151354,283725,403358,2188,1070,578,80,0,0
3/15/2013,ANDHRA PRADESH,17,RANGAREDDI,378238,76675,24516,110984,170921,68327,28006,179311,198927,796,575,349,466,0,0
3/15/2013,ANDHRA PRADESH,18,SRIKAKULAM,560858,49017,28719,62347,302221,25155,171135,87502,473356,306,1176,17,259,0,1
3/15/2013,ANDHRA PRADESH,19,VISAKHAPATNAM,588402,185782,154403,141743,252749,41633,152277,183376,405026,1475,4495,243,0,2,0
3/15/2013,ANDHRA PRADESH,20,VIZIANAGARAM,475573,49897,42960,90892,193302,14171,177208,105063,370510,559,146,86,0,0,4
3/15/2013,ANDHRA PRADESH,21,WARANGAL,205322,192120,137555,83572,75577,26776,19397,110348,94974,207,2104,93,65,1,0
3/15/2013,ANDHRA PRADESH,22,WEST GODAVARI,887247,161390,18632,277550,252275,229183,128239,506733,380514,904,1694,434,151,134,385
3/15/2013,ANDHRA PRADESH,,"Total 
                        :-",13011636,2511798,1126257,2978372,5778267,2171523,2083259,5149895,7861526,34741,31808,7408,6037,177,433
3/15/2013,ARUNACHAL PRADESH,1,ANJAW,3893,0,3893,661,3232,0,0,661,3232,17,37,0,33,0,0
3/15/2013,ARUNACHAL PRADESH,2,CHANGLANG,9971,0,9318,138,7035,2777,21,2915,7056,0,193,0,250,0,25
3/15/2013,ARUNACHAL PRADESH,3,DIBANG VALLEY,1081,4,975,0,1081,0,0,0,1081,15,9,0,0,0,0
3/15/2013,ARUNACHAL PRADESH,4,EAST KAMENG,8465,6,702,1988,3683,2522,272,4510,3955,5,10,7,21,1,0
3/15/2013,ARUNACHAL PRADESH,5,EAST SIANG,8853,0,8853,0,8020,145,688,145,8708,5,46,0,42,6,0
3/15/2013,ARUNACHAL PRADESH,6,KURUNG KUMEY,17061,0,17058,0,17024,37,0,37,17024,12,115,0,0,0,0
3/15/2013,ARUNACHAL PRADESH,7,LOHIT,11999,0,11999,824,8138,3037,0,3861,8138,21,129,22,159,0,7
3/15/2013,ARUNACHAL PRADESH,8,LOWER DIBANG VALLEY,3602,0,3602,869,1494,382,857,1251,2351,54,7,67,8,0,0
3/15/2013,ARUNACHAL PRADESH,9,LOWER SUBANSIRI,8543,0,8543,414,5766,1199,1164,1613,6930,0,123,1,119,0,10
3/15/2013,ARUNACHAL PRADESH,10,PAPUM PARE,1257,0,6928,0,1257,0,0,0,1257,151,58,122,42,0,0
3/15/2013,ARUNACHAL PRADESH,11,TAWANG,5705,0,5555,0,4019,496,1190,496,5209,6,86,1,13,2,0
3/15/2013,ARUNACHAL PRADESH,12,TIRAP,14322,0,14322,8344,5494,383,101,8727,5595,0,254,0,150,0,0
3/15/2013,ARUNACHAL PRADESH,13,UPPER SIANG,4087,0,4087,213,2560,350,964,563,3524,5,76,2,50,0,2
3/15/2013,ARUNACHAL PRADESH,14,UPPER SUBANSIRI,9013,0,9013,23,8989,0,1,23,8990,53,154,2,221,0,0
3/15/2013,ARUNACHAL PRADESH,15,WEST KAMENG,6549,0,6549,751,4961,600,237,1351,5198,191,0,107,4,2,2
3/15/2013,ARUNACHAL PRADESH,16,WEST SIANG,12871,0,12851,29,11447,1395,0,1424,11447,2,255,6,1,0,0
3/15/2013,ARUNACHAL PRADESH,,"Total 
                        :-",127272,10,124248,14254,94200,13323,5495,27577,99695,537,1552,337,1113,11,46
3/15/2013,ASSAM,1,BAGSHA,5005,235,282,0,1450,3019,536,3019,1986,24,12,0,28,0,0
3/15/2013,ASSAM,2,BARPETA,216871,0,0,0,106487,17315,93069,17315,199556,104,1806,1,175,0,0
3/15/2013,ASSAM,3,BONGAIGAON,95653,10313,3437,2015,51929,10185,31524,12200,83453,229,1222,4,59,0,0
3/15/2013,ASSAM,4,CACHAR,180958,33496,7150,2104,119931,12630,46293,14734,166224,70,1839,0,1697,0,0
3/15/2013,ASSAM,5,DARRANG,113721,5810,5567,0,79139,9641,24941,9641,104080,0,673,0,243,0,0
3/15/2013,ASSAM,6,DHEMAJI,104463,225,2262,715,80854,4513,18381,5228,99235,29,850,0,230,0,0
3/15/2013,ASSAM,7,DHUBRI,271266,6989,2150,1713,194324,39172,36057,40885,230381,460,1012,44,576,0,0
3/15/2013,ASSAM,8,DIBRUGARH,202039,6267,21338,2650,57122,96883,45384,99533,102506,219,969,28,606,0,0
3/15/2013,ASSAM,9,GOALPARA,89251,5922,16952,1317,65070,6064,16800,7381,81870,87,1840,175,804,0,0
3/15/2013,ASSAM,10,GOLAGHAT,122906,8602,10650,7486,79743,8646,27031,16132,106774,90,1086,46,119,0,0
3/15/2013,ASSAM,11,HAILAKANDI,64396,5425,257,472,49837,1642,12445,2114,62282,2,1126,0,35,0,0
3/15/2013,ASSAM,12,JORHAT,129054,13261,17504,11455,58852,37000,21747,48455,80599,601,1609,417,951,0,0
3/15/2013,ASSAM,13,KAMRUP,230279,29712,25829,32686,85783,60425,51385,93111,137168,1455,442,40,1531,12,0
3/15/2013,ASSAM,14,KARBI ANGLONG,0,0,0,0,0,0,0,0,0,0,0,0,0,0,0
3/15/2013,ASSAM,15,KARIMGANJ,97153,1264,12,275,78992,2477,15409,2752,94401,360,1051,0,912,0,0
3/15/2013,ASSAM,16,KOKRAJHAR,33387,1356,12783,56,17284,7725,8322,7781,25606,11,293,0,63,0,0
3/15/2013,ASSAM,17,LAKHIMPUR,126421,13329,33431,16063,73224,14452,22682,30515,95906,286,1415,4,268,0,0
3/15/2013,ASSAM,18,MARIGAON,133883,120,270,0,59634,560,73689,560,133323,0,300,0,750,0,0
3/15/2013,ASSAM,19,NAGAON,242531,29337,16592,6343,159312,26199,50677,32542,209989,10,2468,72,591,2,0
3/15/2013,ASSAM,20,NALBARI,127388,5689,2605,121,79902,8939,38426,9060,118328,780,282,0,710,0,0
3/15/2013,ASSAM,21,SIBSAGAR,150631,5680,5903,4083,74272,22339,49937,26422,124209,382,2102,21,922,0,0
3/15/2013,ASSAM,22,SONITPUR,230738,13216,23141,17735,119266,36701,57036,54436,176302,442,1951,87,606,0,1
3/15/2013,ASSAM,23,TINSUKIA,167396,6892,11520,874,67748,69075,29699,69949,97447,309,859,0,595,0,0
3/15/2013,ASSAM,24,UDALGURI,0,0,0,0,0,0,0,0,0,0,0,0,0,0,0
3/15/2013,ASSAM,,"Total 
                        :-",3135390,203140,219635,108163,1760155,495602,771470,603765,2531625,5950,25207,939,12471,14,1
3/15/2013,BIHAR,1,ARARIA,174614,0,0,0,99900,520,74194,520,174094,0,1354,0,0,0,0
3/15/2013,BIHAR,2,ARWAL,96134,0,0,1866,49621,1621,43026,3487,92647,11,374,0,0,0,0
3/15/2013,BIHAR,3,AURANGABAD,213913,0,0,0,123115,408,90390,408,213505,4,7,2,0,0,0
3/15/2013,BIHAR,4,BANKA,86663,57482,1115,1788,81907,2968,0,4756,81907,32,926,52,7,27,2
3/15/2013,BIHAR,5,BEGUSARAI,410947,77164,87,9297,191885,24279,185486,33576,377371,44,479,60,192,9,12
3/15/2013,BIHAR,6,BHAGALPUR,340102,0,0,7061,148238,2292,182511,9353,330749,5,1368,0,11,0,0
3/15/2013,BIHAR,7,BHOJPUR,313835,0,0,5418,163607,26487,118323,31905,281930,65,1390,36,160,0,0
3/15/2013,BIHAR,8,BUXAR,167724,0,0,1275,77997,16722,71730,17997,149727,441,348,24,51,0,0
3/15/2013,BIHAR,9,DARBHANGA,641347,0,0,12056,346712,7325,275254,19381,621966,578,892,76,820,0,0
3/15/2013,BIHAR,10,GAYA,444020,9024,0,13378,295570,25417,109655,38795,405225,529,1778,12,151,0,0
3/15/2013,BIHAR,11,GOPALGANJ,222302,0,0,4440,145598,16128,56136,20568,201734,11,1135,21,71,0,8
3/15/2013,BIHAR,12,JAMUI,237566,69095,16919,102,108718,11331,117415,11433,226133,3,158,1,77,0,0
3/15/2013,BIHAR,13,JEHANABAD,94239,468,0,1167,51868,2853,38351,4020,90219,7,55,0,25,0,1
3/15/2013,BIHAR,14,KAIMUR(BHABUA),158260,0,0,555,79620,8676,69409,9231,149029,15,0,0,0,0,0
3/15/2013,BIHAR,15,KATIHAR,423393,0,0,2632,252534,18326,149901,20958,402435,0,1198,0,86,0,51
3/15/2013,BIHAR,16,KHAGARIA,253911,1202,0,23573,118764,48350,63224,71923,181988,269,411,56,0,0,0
3/15/2013,BIHAR,17,KISHANGANJ,232581,12786,8399,0,107253,10391,114937,10391,222190,112,1223,0,100,0,50
3/15/2013,BIHAR,18,LAKHISARAI,128624,24762,1587,464,73964,9753,44443,10217,118407,314,293,0,0,0,0
3/15/2013,BIHAR,19,MADHEPURA,259483,4267,6870,27666,106730,26850,98237,54516,204967,175,18,39,27,0,0
3/15/2013,BIHAR,20,MADHUBANI,148945,26934,0,3418,67429,8397,69701,11815,137130,703,894,9,0,3,0
3/15/2013,BIHAR,21,MUNGER,162640,0,0,13770,85688,18184,44998,31954,130686,0,272,0,0,0,0
3/15/2013,BIHAR,22,MUZAFFARPUR,707866,0,0,44642,328425,58363,276436,103005,604861,37,221,266,0,0,0
3/15/2013,BIHAR,23,NALANDA,318434,39515,0,3828,151973,5065,157568,8893,309541,878,911,29,187,11,0
3/15/2013,BIHAR,24,NAWADA,229485,149122,10,7421,141019,13059,67986,20480,209005,111,672,3,499,0,50
3/15/2013,BIHAR,25,PASHCHIM CHAMPARAN,239032,494,3,6077,219036,3281,10638,9358,229674,197,34,24,252,0,0
3/15/2013,BIHAR,26,PATNA,496779,85641,8,43967,194494,66648,191670,110615,386164,12,2710,0,213,0,0
3/15/2013,BIHAR,27,PURBA CHAMPARAN,654777,131351,0,106901,285403,17533,244940,124434,530343,374,1623,0,6,0,43
3/15/2013,BIHAR,28,PURNIA,455203,55489,20257,432,171263,14170,269338,14602,440601,251,1140,9,83,0,49
3/15/2013,BIHAR,29,SAHARSA,122592,589,6,7950,101291,4969,8382,12919,109673,4,745,1,2,0,0
3/15/2013,BIHAR,30,SAMASTIPUR,598491,0,11,21879,315594,20196,240822,42075,556416,618,10,176,406,0,0
3/15/2013,BIHAR,31,SARAN,489391,5101,0,1957,189465,17420,280549,19377,470014,76,38,152,0,0,0
3/15/2013,BIHAR,32,SASARAM(ROHTAS),361705,57982,2292,3842,179343,4135,174385,7977,353728,344,1565,1,264,0,5
3/15/2013,BIHAR,33,SHEIKHPURA,72912,25873,22,2740,43575,6332,20265,9072,63840,0,0,1,55,3,0
3/15/2013,BIHAR,34,SHEOHAR,100210,0,0,52,56915,486,42757,538,99672,5,265,0,2,1,47
3/15/2013,BIHAR,35,SITAMARHI,142438,3491,519,250,32430,1001,108757,1251,141187,34,1290,7,30,1,49
3/15/2013,BIHAR,36,SIWAN,383108,0,0,5599,233045,7839,136625,13438,369670,18,1356,0,16,0,0
3/15/2013,BIHAR,37,SUPAUL,291996,50256,1149,0,155557,11,136428,11,291985,3,996,0,8,0,0
3/15/2013,BIHAR,38,VAISHALI,373041,0,0,140,183843,200,188858,340,372701,549,16,47,0,0,0
3/15/2013,BIHAR,,"Total 
                        :-",11248703,888088,59254,387603,5759389,527986,4573725,915589,10333114,6829,28165,1104,3801,55,367
3/15/2013,CHHATTISGARH,1,BASTAR(JAGDALPUR),224839,5872,127940,5134,126794,6615,86297,11749,213091,271,3471,212,1074,5,17
3/15/2013,CHHATTISGARH,2,BILASPUR,371399,869,8700,853,202904,1657,165985,2510,368889,0,2524,0,1194,0,0
3/15/2013,CHHATTISGARH,3,DANTEWADA,115788,336,13764,6838,73526,4965,30459,11803,103985,405,1475,176,1020,2,0
3/15/2013,CHHATTISGARH,4,DHAMTARI,122676,8569,38390,6119,38313,5488,72756,11607,111069,256,1627,50,321,1,0
3/15/2013,CHHATTISGARH,5,DURG,348076,14531,26337,14167,101901,14318,217690,28485,319591,1209,1466,289,291,5,0
3/15/2013,CHHATTISGARH,6,JANJGIR - CHAMPA,221272,51126,26344,7603,106569,24127,82973,31730,189542,120,2908,737,52,2,0
3/15/2013,CHHATTISGARH,7,JASHPUR,141873,3190,48424,6427,56062,7745,71639,14172,127701,890,1401,106,289,0,4
3/15/2013,CHHATTISGARH,8,KANKER,115378,5424,66214,2078,50835,1900,60565,3978,111400,33,1737,220,344,0,50
3/15/2013,CHHATTISGARH,9,KAWARDHA(KABIRDHAM),101715,0,0,2169,52932,6381,40233,8550,93165,1,1344,6,141,0,0
3/15/2013,CHHATTISGARH,10,KORBA,138150,0,0,0,71191,566,66393,566,137584,2,2081,2,888,0,0
3/15/2013,CHHATTISGARH,11,KORIYA,77822,4570,32898,1240,38251,1235,37096,2475,75347,27,2264,74,947,0,13
3/15/2013,CHHATTISGARH,12,MAHASAMUND,172481,25894,55892,1310,97835,2723,70613,4033,168448,229,1261,7,140,0,4
3/15/2013,CHHATTISGARH,13,RAIGARH,209401,27338,61624,2019,128378,4798,74206,6817,202584,50,2006,25,904,4,8
3/15/2013,CHHATTISGARH,14,RAIPUR,456778,80291,72576,58748,159859,59606,178565,118354,338424,2681,1609,503,185,1,0
3/15/2013,CHHATTISGARH,15,RAJNANDGAON,205040,17936,66632,6332,76544,10539,111625,16871,188169,238,1989,144,622,0,0
3/15/2013,CHHATTISGARH,16,SURGUJA,385384,0,0,42292,168828,2788,171476,45080,340304,17,3047,4,466,0,5
3/15/2013,CHHATTISGARH,,"Total 
                        :-",3408072,245946,645735,163329,1550722,155451,1538571,318780,3089293,6429,32210,2555,8878,20,101
3/15/2013,D & N HAVELI,1,DADRA AND NAGAR HAVELI,0,0,0,0,0,0,0,0,0,0,0,0,0,0,0
3/15/2013,D & N HAVELI,,"Total 
                        :-",0,0,0,0,0,0,0,0,0,0,0,0,0,0,0
3/15/2013,GOA,1,NORTH GOA,59768,2157,468,307,3698,55763,0,56070,3698,415,99,166,0,0,0
3/15/2013,GOA,2,SOUTH GOA,65260,251,1039,1210,1725,35611,26714,36821,28439,180,134,49,272,0,0
3/15/2013,GOA,,"Total 
                        :-",125028,2408,1507,1517,5423,91374,26714,92891,32137,595,233,215,272,0,0
3/15/2013,GUJARAT,1,AHMEDABAD,271385,34538,5678,29212,75235,83402,83536,112614,158771,70,902,82,314,1,46
3/15/2013,GUJARAT,2,AMRELI,193340,20939,1,22598,63014,50822,56906,73420,119920,768,678,487,732,3,52
3/15/2013,GUJARAT,3,ANAND,286920,28515,8360,35404,82760,94516,74240,129920,157000,390,515,879,243,23,52
3/15/2013,GUJARAT,4,BANAS KANTHA,433962,4593,2155,36155,125376,50033,222398,86188,347774,22,2038,20,1279,8,62
3/15/2013,GUJARAT,5,BHARUCH,231499,12625,78324,31623,58601,75231,66044,106854,124645,23,789,15,882,7,65
3/15/2013,GUJARAT,6,BHAVNAGAR,101327,5562,36,635,31244,10590,58858,11225,90102,140,796,97,998,25,39
3/15/2013,GUJARAT,7,DAHOD,160043,7929,150694,0,124000,2043,34000,2043,158000,387,1172,3,1897,0,87
3/15/2013,GUJARAT,8,DANGS,39343,185,39068,187,27900,453,10803,640,38703,383,85,134,288,33,40
3/15/2013,GUJARAT,9,GANDHINAGAR,97006,4379,964,3,13737,62268,20998,62271,34735,41,598,13,630,13,41
3/15/2013,GUJARAT,10,JAMNAGAR,222755,14676,239,11184,66456,44404,100711,55588,167167,898,784,546,650,31,67
3/15/2013,GUJARAT,11,JUNAGADH,310966,22768,2331,46585,90437,43451,130493,90036,220930,159,982,11,508,0,50
3/15/2013,GUJARAT,12,KACHCHH,248674,5586,216,4770,43013,63853,137038,68623,180051,85,945,73,314,0,84
3/15/2013,GUJARAT,13,KHEDA,326254,23113,7913,61541,104317,65025,95371,126566,199688,437,1204,174,1631,23,82
3/15/2013,GUJARAT,14,MAHESANA,320193,5949,0,7508,57207,63870,191608,71378,248815,666,268,726,1315,5,57
3/15/2013,GUJARAT,15,NARMADA,104115,2251,69813,1377,58730,26623,17385,28000,76115,261,416,11,520,0,65
3/15/2013,GUJARAT,16,NAVSARI,209227,3006,112157,10622,73486,35008,90111,45630,163597,474,592,99,1118,15,79
3/15/2013,GUJARAT,17,PANCH MAHALS,322283,15735,92114,20976,159912,102176,39219,123152,199131,393,2044,301,1047,19,61
3/15/2013,GUJARAT,18,PATAN,208376,15087,1357,4771,92051,16786,94768,21557,186819,418,795,202,780,0,58
3/15/2013,GUJARAT,19,PORBANDAR,67699,5548,376,5408,17024,10514,34753,15922,51777,142,306,117,110,12,64
3/15/2013,GUJARAT,20,RAJKOT,327946,15161,9330,21959,130374,51870,123743,73829,254117,653,1712,311,633,24,71
3/15/2013,GUJARAT,21,SABAR KANTHA,444887,27070,62558,4320,151382,29538,259647,33858,411029,36,3611,28,1304,0,63
3/15/2013,GUJARAT,22,SURAT,406006,8630,266090,51894,160397,86506,107209,138400,267606,691,1096,562,1537,0,51
3/15/2013,GUJARAT,23,SURENDRANAGAR,165976,19442,3454,1520,55834,7142,101480,8662,157314,405,781,16,1298,3,55
3/15/2013,GUJARAT,24,VADODARA,440874,15444,86876,56694,140958,115395,127827,172089,268785,83,1104,50,1956,11,44
3/15/2013,GUJARAT,25,VALSAD,237452,11159,164412,42822,79836,74053,40741,116875,120577,286,755,327,934,3,98
3/15/2013,GUJARAT,,"Total 
                        :-",6178508,329890,1164516,509768,2083281,1265572,2319887,1775340,4403168,8311,24968,5284,22918,259,1533
3/15/2013,HARYANA,1,AMBALA,101594,32008,0,1670,31718,19342,48864,21012,80582,9,576,7,590,3,65
3/15/2013,HARYANA,2,BHIWANI,202740,40163,0,14633,47488,70292,70327,84925,117815,59,339,302,439,0,29
3/15/2013,HARYANA,3,FARIDABAD,131580,30247,0,2516,15833,30366,82865,32882,98698,348,259,80,627,15,0
3/15/2013,HARYANA,4,FATEHABAD,131813,32600,0,1953,25642,47766,56452,49719,82094,743,429,99,171,0,23
3/15/2013,HARYANA,5,GURGAON,92830,20491,0,3277,10502,27865,51186,31142,61688,225,132,127,344,56,1
3/15/2013,HARYANA,6,HISAR,206968,49473,0,2681,46065,56710,101512,59391,147577,45,796,37,391,1,54
3/15/2013,HARYANA,7,JHAJJAR,123578,22748,0,2127,22014,26706,72731,28833,94745,274,153,52,447,1,45
3/15/2013,HARYANA,8,JIND,186332,42629,0,6546,53509,18113,108164,24659,161673,439,3,449,393,0,0
3/15/2013,HARYANA,9,KAITHAL,117878,23367,57,5084,36861,29847,46086,34931,82947,446,126,100,3,17,71
3/15/2013,HARYANA,10,KARNAL,158132,37877,0,17968,39445,56624,44095,74592,83540,164,506,362,303,5,76
3/15/2013,HARYANA,11,KURUKSHETRA,98970,27420,0,5637,22292,24508,46533,30145,68825,162,214,129,241,0,49
3/15/2013,HARYANA,12,MAHENDRAGARH,114891,19575,0,213,17500,17178,80000,17391,97500,308,253,169,554,6,81
3/15/2013,HARYANA,13,MEWAT,147377,14407,0,10918,21935,15551,98973,26469,120908,196,376,46,175,9,33
3/15/2013,HARYANA,14,PANCHKULA,35272,3589,0,951,8702,6839,18780,7790,27482,108,112,6,68,2,16
3/15/2013,HARYANA,15,PANIPAT,118364,20217,0,3438,25887,50490,38549,53928,64436,117,87,315,207,14,2
3/15/2013,HARYANA,16,REWARI,112943,21038,0,1267,27943,19577,64156,20844,92099,57,620,230,0,20,40
3/15/2013,HARYANA,17,ROHTAK,102117,23018,0,74,22140,221,79682,295,101822,24,129,0,17,0,60
3/15/2013,HARYANA,18,SIRSA,148306,33666,0,12050,24631,84104,27521,96154,52152,355,44,94,246,2,0
3/15/2013,HARYANA,19,SONIPAT,189263,38741,0,13134,29808,79048,67273,92182,97081,55,100,266,368,0,50
3/15/2013,HARYANA,20,YAMUNANAGAR,126071,37170,0,2465,28933,47484,47189,49949,76122,68,437,80,356,1,47
3/15/2013,HARYANA,,"Total 
                        :-",2647019,570444,57,108602,558848,728631,1250938,837233,1809786,4202,5691,2950,5940,152,742
3/15/2013,HIMACHAL PRADESH,1,BILASPUR,73809,18421,3177,5560,11931,17663,38655,23223,50586,475,312,174,286,0,13
3/15/2013,HIMACHAL PRADESH,2,CHAMBA,87351,17944,24750,3138,44027,8540,31646,11678,75673,563,1023,0,105,0,41
3/15/2013,HIMACHAL PRADESH,3,HAMIRPUR,97488,15957,306,8410,11498,33864,43716,42274,55214,467,317,453,502,0,10
3/15/2013,HIMACHAL PRADESH,4,KANGRA,290691,57721,14576,20214,44901,76417,149159,96631,194060,1328,1083,145,1045,19,0
3/15/2013,HIMACHAL PRADESH,5,KINNAUR,17763,5898,11865,1336,1558,2362,12507,3698,14065,92,175,3,33,0,0
3/15/2013,HIMACHAL PRADESH,6,KULLU,66081,19269,1813,1472,9573,13214,41822,14686,51395,593,303,53,321,4,49
3/15/2013,HIMACHAL PRADESH,7,LAHAUL & SPITI,5440,550,4890,1731,680,2498,531,4229,1211,139,123,2,108,0,0
3/15/2013,HIMACHAL PRADESH,8,MANDI,205356,56371,5371,6924,34407,46228,117797,53152,152204,633,1441,586,60,1,57
3/15/2013,HIMACHAL PRADESH,9,SHIMLA,109998,32753,497,7753,23874,25307,53064,33060,76938,351,1871,24,901,0,0
3/15/2013,HIMACHAL PRADESH,10,SIRMAUR,71024,9227,1187,1611,12001,12436,44976,14047,56977,330,825,0,133,0,33
3/15/2013,HIMACHAL PRADESH,11,SOLAN,70147,23679,2484,7002,10858,22938,29349,29940,40207,635,426,200,236,11,42
3/15/2013,HIMACHAL PRADESH,12,UNA,90838,21728,1233,7105,8320,33344,42069,40449,50389,537,150,100,385,0,11
3/15/2013,HIMACHAL PRADESH,,"Total 
                        :-",1185986,279518,72149,72256,213628,294811,605291,367067,818919,6143,8049,1740,4115,35,256
3/15/2013,JAMMU & KASHMIR,1,ANANTNAG,52249,0,2338,11120,21736,5316,14077,16436,35813,56,53,7,3,4,0
3/15/2013,JAMMU & KASHMIR,2,BANDIPORA,2859,0,0,915,1200,355,389,1270,1589,0,0,0,0,0,0
3/15/2013,JAMMU & KASHMIR,3,BARAMULLA,3863,0,255,488,2030,869,476,1357,2506,15,28,0,19,0,0
3/15/2013,JAMMU & KASHMIR,4,BUDGAM,72371,0,2406,10497,29943,14063,17868,24560,47811,358,200,16,37,28,22
3/15/2013,JAMMU & KASHMIR,5,DODA,59551,8357,5022,8825,32163,8410,10153,17235,42316,450,523,1,17,27,0
3/15/2013,JAMMU & KASHMIR,6,JAMMU,177725,73047,10596,6638,33397,49494,88196,56132,121593,905,295,17,27,86,44
3/15/2013,JAMMU & KASHMIR,7,KARGIL,0,0,0,0,0,0,0,0,0,0,0,0,0,0,0
3/15/2013,JAMMU & KASHMIR,8,KATHUA,81919,18621,6145,2430,18711,10646,50132,13076,68843,749,319,12,33,9,0
3/15/2013,JAMMU & KASHMIR,9,KISHTWAR,22350,2577,5601,6323,16027,0,0,6323,16027,163,462,181,0,2,0
3/15/2013,JAMMU & KASHMIR,10,KULGAM,61270,1036,5192,9728,25581,8996,16965,18724,42546,158,385,60,275,15,45
3/15/2013,JAMMU & KASHMIR,11,KUPWARA,0,0,0,0,0,0,0,0,0,0,0,0,0,0,0
3/15/2013,JAMMU & KASHMIR,12,LEH (LADAKH),10290,0,10290,2210,2268,5812,0,8022,2268,110,75,53,42,54,36
3/15/2013,JAMMU & KASHMIR,13,POONCH,65880,14,26058,11153,28640,8053,18034,19206,46674,526,356,1,48,5,0
3/15/2013,JAMMU & KASHMIR,14,PULWAMA,48334,0,0,0,23492,15268,9574,15268,33066,0,617,0,16,3,47
3/15/2013,JAMMU & KASHMIR,15,RAJAURI,90021,5972,34009,5094,36427,7347,41153,12441,77580,552,801,2,5,9,1
3/15/2013,JAMMU & KASHMIR,16,RAMBAN,34334,31,2150,8408,14359,5515,6052,13923,20411,350,294,0,23,1,0
3/15/2013,JAMMU & KASHMIR,17,REASI,48328,7440,15540,2997,20203,25128,0,28125,20203,268,222,92,45,25,4
3/15/2013,JAMMU & KASHMIR,18,SAMBA,45637,13212,3150,1315,7959,36363,0,37678,7959,328,51,25,20,13,0
3/15/2013,JAMMU & KASHMIR,19,SHOPIAN,10196,0,112,0,10196,0,0,0,10196,0,300,0,8,0,10
3/15/2013,JAMMU & KASHMIR,20,SRINAGAR,3160,0,360,859,719,1273,309,2132,1028,11,4,15,26,13,0
3/15/2013,JAMMU & KASHMIR,21,UDHAMPUR,67838,16358,7282,7416,23593,8796,28033,16212,51626,794,530,12,18,10,25
3/15/2013,JAMMU & KASHMIR,,"Total 
                        :-",958175,146665,136506,96416,348644,211704,301411,308120,650055,5793,5515,494,662,304,234
3/15/2013,JHARKHAND,1,BOKARO,116246,1190,1796,0,103125,2342,10779,2342,113904,0,1364,0,102,3,6
3/15/2013,JHARKHAND,2,CHATRA,138135,34118,5215,12743,98213,2407,24772,15150,122985,74,909,67,476,0,19
3/15/2013,JHARKHAND,3,DEOGHAR,156684,0,0,0,72783,0,83901,0,156684,296,0,0,225,0,1
3/15/2013,JHARKHAND,4,DHANBAD,194074,33001,33950,0,104672,737,88665,737,193337,5,2125,5,44,0,0
3/15/2013,JHARKHAND,5,DUMKA,185659,1,0,65,148732,552,36310,617,185042,179,2776,4,115,0,0
3/15/2013,JHARKHAND,6,GARHWA,127828,110,0,3321,73442,4518,46547,7839,119989,0,469,0,713,0,0
3/15/2013,JHARKHAND,7,GIRIDIH,209494,726,1509,3112,155016,7306,44060,10418,199076,21,68,19,741,0,27
3/15/2013,JHARKHAND,8,GODDA,200289,20873,55650,0,95732,0,104557,0,200289,26,1612,16,73,0,0
3/15/2013,JHARKHAND,9,GUMLA,197017,15534,130732,5294,89998,4651,97074,9945,187072,229,807,112,307,0,0
3/15/2013,JHARKHAND,10,HAZARIBAGH,212453,38658,15162,14199,127150,5937,65167,20136,192317,617,951,89,162,1,0
3/15/2013,JHARKHAND,11,JAMTARA,94923,0,0,0,67240,168,27515,168,94755,52,214,39,214,1,0
3/15/2013,JHARKHAND,12,KHUNTI,74086,25162,36118,11277,44931,6575,11303,17852,56234,16,8,9,2,0,0
3/15/2013,JHARKHAND,13,KODERMA,43808,8974,5971,204,39939,284,3381,488,43320,7,452,3,343,0,0
3/15/2013,JHARKHAND,14,LATEHAR,101730,28808,42641,2393,79635,5150,14552,7543,94187,5,1725,7,303,0,0
3/15/2013,JHARKHAND,15,LOHARDAGA,47855,2073,35728,0,22626,0,25229,0,47855,0,313,0,307,0,7
3/15/2013,JHARKHAND,16,PAKUR,101317,6193,45239,114,72250,556,28397,670,100647,0,800,0,531,0,0
3/15/2013,JHARKHAND,17,PALAMU,246764,78009,19719,7364,91145,10178,138077,17542,229222,51,470,32,80,0,6
3/15/2013,JHARKHAND,18,PASCHIM SINGHBHUM,206313,8736,144604,842,170083,1949,33439,2791,203522,322,3063,156,361,0,7
3/15/2013,JHARKHAND,19,PURBI SINGHBHUM,167469,16256,28337,4033,96510,2353,64573,6386,161083,33,320,17,126,0,0
3/15/2013,JHARKHAND,20,RAMGARH,62188,8609,19090,10,48949,6,13223,16,62172,92,262,30,39,0,1
3/15/2013,JHARKHAND,21,RANCHI,266921,69480,106133,29732,179077,18702,39410,48434,218487,148,673,306,699,7,7
3/15/2013,JHARKHAND,22,SAHIBGANJ,126623,8045,39815,630,112674,835,12484,1465,125158,150,615,24,800,0,0
3/15/2013,JHARKHAND,23,SERAIKELA KHARSAWAN,163994,8990,84309,0,103882,683,59429,683,163311,86,877,30,357,2,0
3/15/2013,JHARKHAND,24,SIMDEGA,89016,8815,59919,4299,54556,2187,27974,6486,82530,121,96,26,160,0,0
3/15/2013,JHARKHAND,,"Total 
                        :-",3530886,422361,911637,99632,2252360,78076,1100818,177708,3353178,2530,20969,991,7280,14,81
3/15/2013,KARNATAKA,1,BAGALKOT,224399,38647,8849,180,74902,53,149264,233,224166,48,744,12,1014,0,0
3/15/2013,KARNATAKA,2,BANGALORE RURAL,140884,35298,9393,15711,63044,23386,38743,39097,101787,526,1246,284,414,0,4
3/15/2013,KARNATAKA,3,BANGALORE URBAN,194239,44147,4346,37600,49690,79651,27298,117251,76988,722,85,336,413,1,42
3/15/2013,KARNATAKA,4,BELGAUM,718036,78562,39491,47168,186678,55223,428967,102391,615645,776,1994,27,1618,3,25
3/15/2013,KARNATAKA,5,BELLARY,252818,53709,54466,36203,100160,30697,85758,66900,185918,400,852,418,582,5,93
3/15/2013,KARNATAKA,6,BIDAR,234074,51715,39119,56210,58384,45286,74194,101496,132578,1012,108,833,101,6,0
3/15/2013,KARNATAKA,7,BIJAPUR,235808,6043,1270,4776,122381,16310,92341,21086,214722,964,1032,506,599,6,0
3/15/2013,KARNATAKA,8,CHAMARAJANAGAR,173032,42444,16432,27547,110188,6500,28797,34047,138985,615,263,1,871,0,0
3/15/2013,KARNATAKA,9,CHICKMAGALUR,179144,38366,8137,18941,35757,43818,80628,62759,116385,641,926,480,739,0,0
3/15/2013,KARNATAKA,10,CHITRADURGA,257955,72463,60539,9429,74948,56105,117473,65534,192421,733,659,65,1016,5,5
3/15/2013,KARNATAKA,11,DAVANGERE,264812,61020,34921,8182,83670,18137,154823,26319,238493,541,905,5,971,0,0
3/15/2013,KARNATAKA,12,DHARWAD,136286,13842,11540,11879,53596,10544,60267,22423,113863,554,615,0,586,0,17
3/15/2013,KARNATAKA,13,GADAG,107855,23459,11880,8510,46821,13004,39520,21514,86341,352,291,7,431,21,27
3/15/2013,KARNATAKA,14,GULBARGA,441542,7903,7283,42,268718,850,171932,892,440650,439,4024,16,2232,0,50
3/15/2013,KARNATAKA,15,HASSAN,333834,58121,13226,37119,64134,16298,216283,53417,280417,602,1902,683,1173,0,15
3/15/2013,KARNATAKA,16,HAVERI,193163,28096,17548,6019,98278,30991,57875,37010,156153,349,818,162,785,0,46
3/15/2013,KARNATAKA,17,KODAGU,105683,11539,9359,4062,38838,44688,18095,48750,56933,284,179,284,287,0,50
3/15/2013,KARNATAKA,18,KOLAR,381339,96049,46337,14229,107858,84568,174684,98797,282542,2723,1715,173,2162,0,0
3/15/2013,KARNATAKA,19,KOPPAL,213700,19011,13887,0,60868,291,152541,291,213409,111,609,26,610,0,50
3/15/2013,KARNATAKA,20,MANDYA,313960,48292,4881,8995,112126,44946,147893,53941,260019,1043,1602,51,703,1,26
3/15/2013,KARNATAKA,21,MANGALORE(DAKSHINA KANNADA),255913,20065,12210,49583,59478,111320,35532,160903,95010,376,1236,1045,505,8,70
3/15/2013,KARNATAKA,22,MYSORE,304720,65834,38229,45909,76614,65726,116471,111635,193085,142,305,128,245,0,0
3/15/2013,KARNATAKA,23,RAICHUR,234772,41296,39052,10033,94934,9279,120526,19312,215460,1231,356,396,230,10,0
3/15/2013,KARNATAKA,24,RAMANAGARA,169409,23856,4578,17613,41876,51113,58807,68726,100683,591,1360,273,501,0,9
3/15/2013,KARNATAKA,25,SHIMOGA,219588,42443,12988,45324,98863,35716,39685,81040,138548,983,951,568,960,0,0
3/15/2013,KARNATAKA,26,TUMKUR,468476,90573,38239,42139,242872,47220,136245,89359,379117,1939,1641,133,1845,8,50
3/15/2013,KARNATAKA,27,UDUPI,182454,10658,8526,44122,42889,61425,34018,105547,76907,350,345,595,384,0,0
3/15/2013,KARNATAKA,28,UTTAR KANNADA,209255,15780,5062,29952,106046,13473,59784,43425,165830,7,2155,11,1267,0,50
3/15/2013,KARNATAKA,,"Total 
                        :-",7147150,1139231,571788,637477,2574611,1016618,2918444,1654095,5493055,19054,28918,7518,23244,74,629
3/15/2013,KERALA,1,ALAPPUZHA,344155,32737,599,120576,114359,107031,2189,227607,116548,233,138,442,206,0,3
3/15/2013,KERALA,2,ERNAKULAM,479197,192685,4294,144084,54585,264469,16059,408553,70644,232,53,1592,145,0,4
3/15/2013,KERALA,3,IDUKKI,222833,33982,9715,71255,83635,56163,11780,127418,95415,76,100,805,185,0,42
3/15/2013,KERALA,4,KANNUR,316095,20464,3512,121231,34121,160743,0,281974,34121,522,168,1332,350,0,0
3/15/2013,KERALA,5,KASARGOD,165946,4313,2459,21355,56427,64864,23300,86219,79727,262,279,740,382,0,10
3/15/2013,KERALA,6,KOLLAM,355344,55573,989,69295,94679,184242,7128,253537,101807,78,362,755,343,0,33
3/15/2013,KERALA,7,KOTTAYAM,403920,32186,4190,137986,28118,236160,1656,374146,29774,179,182,536,133,0,40
3/15/2013,KERALA,8,KOZHIKODE,431115,32341,2231,139157,42285,247587,2086,386744,44371,186,127,1561,247,0,15
3/15/2013,KERALA,9,MALAPPURAM,585037,51792,3846,232949,36422,311670,3996,544619,40418,182,358,0,0,0,0
3/15/2013,KERALA,10,PALAKKAD,491803,82857,12777,146950,107013,213416,24424,360366,131437,175,162,1031,455,1,5
3/15/2013,KERALA,11,PATHANAMTHITTA,259403,26147,1879,62018,53184,143001,1200,205019,54384,96,172,205,121,14,11
3/15/2013,KERALA,12,THIRUVANANTHAPURAM,550455,67514,5011,111663,126813,302527,9452,414190,136265,28,344,844,496,0,13
3/15/2013,KERALA,13,THRISSUR,449906,41546,1525,187442,48669,207927,5868,395369,54537,731,316,1132,839,0,22
3/15/2013,KERALA,14,WAYANAD,155734,9549,31717,64013,38538,51083,2100,115096,40638,99,57,0,0,0,0
3/15/2013,KERALA,,"Total 
                        :-",5210943,683686,84744,1629974,918848,2550883,111238,4180857,1030086,3079,2818,10975,3902,15,198
3/15/2013,MADHYA PRADESH,1,ALIRAJPUR,66504,783,61692,2870,34778,1202,27654,4072,62432,192,602,65,63,0,2
3/15/2013,MADHYA PRADESH,2,ANUPPUR,122364,11708,76685,11605,38903,10359,61497,21964,100400,429,993,147,408,19,8
3/15/2013,MADHYA PRADESH,3,ASHOKNAGAR,119894,28024,13907,970,54450,2415,62059,3385,116509,0,853,0,37,0,0
3/15/2013,MADHYA PRADESH,4,BALAGHAT,307680,27994,57596,14426,171243,16654,105357,31080,276600,1118,733,422,433,12,19
3/15/2013,MADHYA PRADESH,5,BARWANI,142005,0,0,11870,63684,10303,56148,22173,119832,257,1039,261,350,6,41
3/15/2013,MADHYA PRADESH,6,BETUL,189215,6,20,7556,43745,13144,124770,20700,168515,2,1285,0,30,0,0
3/15/2013,MADHYA PRADESH,7,BHIND,75642,0,0,1650,42573,7083,24336,8733,66909,3,1221,0,66,0,3
3/15/2013,MADHYA PRADESH,8,BHOPAL,67572,18941,3336,5509,19528,6055,36480,11564,56008,189,461,2,155,0,0
3/15/2013,MADHYA PRADESH,9,BURHANPUR,83203,7279,27871,3385,34074,6117,39627,9502,73701,3,658,2,154,0,23
3/15/2013,MADHYA PRADESH,10,CHHATARPUR,240930,54190,12734,4101,72527,4247,160055,8348,232582,300,1859,4,232,0,9
3/15/2013,MADHYA PRADESH,11,CHHINDWARA,304759,59883,68838,10079,117268,16374,160513,26453,277781,203,4840,600,416,1,50
3/15/2013,MADHYA PRADESH,12,DAMOH,147239,1066,313,1583,92368,481,52807,2064,145175,34,1944,16,103,0,21
3/15/2013,MADHYA PRADESH,13,DATIA,56044,0,0,10315,11956,10658,23115,20973,35071,169,257,31,70,0,0
3/15/2013,MADHYA PRADESH,14,DEWAS,161039,0,0,9601,59094,15753,76591,25354,135685,6,887,1,23,1,34
3/15/2013,MADHYA PRADESH,15,DHAR,276411,7804,90258,22141,92776,39281,122213,61422,214989,357,2424,46,345,0,0
3/15/2013,MADHYA PRADESH,16,DINDORI,135663,10017,77435,192,63451,2623,69397,2815,132848,0,1166,0,283,0,6
3/15/2013,MADHYA PRADESH,17,GUNA,118029,0,0,7758,34798,30834,44639,38592,79437,1185,17,405,1,0,9
3/15/2013,MADHYA PRADESH,18,GWALIOR,127370,30222,12025,1146,32128,2589,91507,3735,123635,67,1894,70,140,1,30
3/15/2013,MADHYA PRADESH,19,HARDA,66900,847,550,3307,23589,5886,34118,9193,57707,27,730,17,51,0,4
3/15/2013,MADHYA PRADESH,20,HOSHANGABAD,157337,19328,20326,21976,50677,13493,71191,35469,121868,157,1429,39,609,1,6
3/15/2013,MADHYA PRADESH,21,INDORE,146842,29082,14728,4647,27895,11505,102795,16152,130690,115,648,81,416,0,0
3/15/2013,MADHYA PRADESH,22,JABALPUR,227432,20922,38969,9785,106289,32609,78749,42394,185038,997,1454,614,260,43,10
3/15/2013,MADHYA PRADESH,23,JHABUA,149999,1692,139035,5941,82620,4465,57453,10406,140073,56,1642,8,384,0,10
3/15/2013,MADHYA PRADESH,24,KATNI,157312,41681,27856,5078,53000,6798,92436,11876,145436,1,1710,20,918,4,15
3/15/2013,MADHYA PRADESH,25,KHANDWA(EAST NIMAR),166931,22044,52923,7220,66896,19380,73435,26600,140331,355,744,173,392,0,0
3/15/2013,MADHYA PRADESH,26,KHARGONE,251641,36175,79936,33367,70725,49322,98227,82689,168952,2483,408,531,149,0,6
3/15/2013,MADHYA PRADESH,27,MANDLA,181442,7098,100624,17508,98633,12867,52434,30375,151067,1114,1361,395,300,16,0
3/15/2013,MADHYA PRADESH,28,MANDSAUR,171682,22594,5908,9186,46666,12809,103021,21995,149687,350,1092,28,339,0,48
3/15/2013,MADHYA PRADESH,29,MORENA,208269,43731,4059,4078,32416,15111,156664,19189,189080,259,1706,82,142,1,50
3/15/2013,MADHYA PRADESH,30,NARSINGHPUR,182024,35935,27089,22576,65892,35590,57966,58166,123858,991,317,527,373,31,19
3/15/2013,MADHYA PRADESH,31,NEEMUCH,102282,13365,10911,3137,27831,6615,64699,9752,92530,111,1342,0,62,0,13
3/15/2013,MADHYA PRADESH,32,PANNA,145739,30364,23216,19499,63423,9767,53050,29266,116473,199,1145,43,12,0,2
3/15/2013,MADHYA PRADESH,33,RAISEN,154767,4844,2634,696,69701,1059,83311,1755,153012,57,2192,36,869,0,22
3/15/2013,MADHYA PRADESH,34,RAJGARH,208402,31896,6504,5473,93722,3696,105511,9169,199233,245,1378,3,147,8,0
3/15/2013,MADHYA PRADESH,35,RATLAM,147314,24459,52552,6650,54090,13040,73534,19690,127624,607,436,11,42,0,0
3/15/2013,MADHYA PRADESH,36,REWA,309098,17352,13263,5443,121538,7910,174207,13353,295745,0,4082,1,198,0,4
3/15/2013,MADHYA PRADESH,37,SAGAR,296553,69588,29721,34239,126571,21283,114460,55522,241031,1042,288,123,114,1,0
3/15/2013,MADHYA PRADESH,38,SATNA,336014,51849,50988,6099,158792,67196,103927,73295,262719,490,937,237,515,0,0
3/15/2013,MADHYA PRADESH,39,SEHORE,132984,159,168,11552,34210,18679,68543,30231,102753,608,646,110,78,0,3
3/15/2013,MADHYA PRADESH,40,SEONI,234407,71637,46171,10113,104243,13460,106591,23573,210834,748,2336,197,468,4,0
3/15/2013,MADHYA PRADESH,41,SHAHDOL,177216,13751,70625,5182,84718,10646,76670,15828,161388,646,836,91,752,4,0
3/15/2013,MADHYA PRADESH,42,SHAJAPUR,199410,16055,1457,2927,69825,5029,121631,7956,191456,279,1182,1,108,0,12
3/15/2013,MADHYA PRADESH,43,SHEOPUR,90469,13654,16936,211,18155,380,71723,591,89878,0,654,0,58,0,9
3/15/2013,MADHYA PRADESH,44,SHIVPURI,214022,72059,55972,3981,62283,8514,139244,12495,201527,99,2403,3,147,1,0
3/15/2013,MADHYA PRADESH,45,SIDHI,205883,30024,57050,9125,112006,5385,79367,14510,191373,721,1451,50,54,3,0
3/15/2013,MADHYA PRADESH,46,SINGRAULI,128690,18264,41270,12473,24915,2317,49067,14790,73982,721,421,69,40,3,0
3/15/2013,MADHYA PRADESH,47,TIKAMGARH,171959,57584,10331,6255,66822,1437,97445,7692,164267,38,1191,0,108,0,0
3/15/2013,MADHYA PRADESH,48,UJJAIN,183195,56526,5033,831,67737,10004,104623,10835,172360,43,988,25,298,4,10
3/15/2013,MADHYA PRADESH,49,UMARIA,111469,6658,55814,7,51236,4112,56003,4119,107239,67,1418,23,449,0,22
3/15/2013,MADHYA PRADESH,50,VIDISHA,192212,0,0,3233,95981,3014,89984,6247,185965,77,1901,0,145,0,12
3/15/2013,MADHYA PRADESH,,"Total 
                        :-",8551459,1139134,1565329,418552,3312441,629550,4150844,1048102,7463285,18217,63601,5610,12306,164,532
3/15/2013,MAHARASHTRA,1,AHMEDNAGAR,526138,69218,45447,28860,125038,68757,303483,97617,428521,286,2108,281,2196,39,50
3/15/2013,MAHARASHTRA,2,AKOLA,188972,0,0,20791,70432,25759,71990,46550,142422,55,630,33,546,2,0
3/15/2013,MAHARASHTRA,3,AMRAVATI,373209,78235,60878,80409,120938,76838,95024,157247,215962,404,1300,346,1370,15,14
3/15/2013,MAHARASHTRA,4,AURANGABAD,306868,46720,22165,12412,69687,34805,189964,47217,259651,241,242,191,242,43,22
3/15/2013,MAHARASHTRA,5,BEED,325770,40092,2892,2570,90490,13312,219398,15882,309888,29,1045,12,972,0,0
3/15/2013,MAHARASHTRA,6,BHANDARA,198132,0,0,37510,75719,46935,37968,84445,113687,122,729,32,839,0,0
3/15/2013,MAHARASHTRA,7,BULDHANA,364387,0,0,19613,117264,33500,194010,53113,311274,377,1835,12,1522,5,2
3/15/2013,MAHARASHTRA,8,CHANDRAPUR,336163,48928,63062,41803,126317,77678,90365,119481,216682,271,1265,262,1724,0,43
3/15/2013,MAHARASHTRA,9,DHULE,216968,15959,48957,17652,106598,20687,72031,38339,178629,37,1397,31,1347,89,118
3/15/2013,MAHARASHTRA,10,GADCHIROLI,170962,27065,63918,13526,75900,28423,53113,41949,129013,558,718,105,1321,0,52
3/15/2013,MAHARASHTRA,11,GONDIA,199980,32377,39044,25403,90797,32283,51497,57686,142294,174,734,61,1057,0,0
3/15/2013,MAHARASHTRA,12,HINGOLI,139108,0,0,2606,45940,6706,83856,9312,129796,0,651,2,646,0,0
3/15/2013,MAHARASHTRA,13,JALGAON,553063,62505,74970,56487,188704,80991,226881,137478,415585,419,1608,144,2215,258,254
3/15/2013,MAHARASHTRA,14,JALNA,216279,34670,4997,17587,44910,17412,136370,34999,181280,87,890,71,984,5,3
3/15/2013,MAHARASHTRA,15,KOLHAPUR,459060,25290,209,24940,53177,178594,202349,203534,255526,39,1705,1,2225,0,138
3/15/2013,MAHARASHTRA,16,LATUR,274187,55418,7041,19540,69056,52245,133346,71785,202402,727,2253,282,1017,8,18
3/15/2013,MAHARASHTRA,17,NAGPUR,317096,50757,36282,48974,60836,116506,90780,165480,151616,661,1535,669,904,2,113
3/15/2013,MAHARASHTRA,18,NANDED,303502,67841,31750,5102,100643,9873,187884,14975,288527,10,2708,5,1551,0,1
3/15/2013,MAHARASHTRA,19,NANDURBAR,241682,4058,179495,36784,133973,3682,67243,40466,201216,69,2196,54,863,0,32
3/15/2013,MAHARASHTRA,20,NASHIK,576758,591,445,32826,151355,52832,339745,85658,491100,0,2072,5,2072,3,7
3/15/2013,MAHARASHTRA,21,OSMANABAD,217160,46872,5440,20901,54312,28351,113596,49252,167908,236,460,203,462,1,0
3/15/2013,MAHARASHTRA,22,PARBHANI,186392,28980,4681,7635,53606,11643,113508,19278,167114,237,986,73,753,2,4
3/15/2013,MAHARASHTRA,23,PUNE,571273,58991,40737,23369,90492,164518,293314,187887,383806,545,4381,534,2446,105,172
3/15/2013,MAHARASHTRA,24,RAIGAD,356317,15321,44848,19670,83138,80938,172571,100608,255709,1055,1602,479,1329,107,442
3/15/2013,MAHARASHTRA,25,RATNAGIRI,339799,25294,1136,21948,93026,84319,140506,106267,233532,1153,1803,384,1080,48,30
3/15/2013,MAHARASHTRA,26,SANGLI,275886,47790,630,30529,16991,114132,114234,144661,131225,81,709,97,765,2,0
3/15/2013,MAHARASHTRA,27,SATARA,435802,37989,2848,18885,50314,103378,263225,122263,313539,516,2330,249,2456,265,226
3/15/2013,MAHARASHTRA,28,SINDHUDURG,178784,2869,68,22838,38608,50333,67005,73171,105613,208,2032,52,918,4,34
3/15/2013,MAHARASHTRA,29,SOLAPUR,431374,92090,12799,39461,106080,66720,219113,106181,325193,561,2191,571,1895,85,27
3/15/2013,MAHARASHTRA,30,THANE,577559,24840,198068,3582,230916,43563,299498,47145,530414,5,3915,3,2467,3,86
3/15/2013,MAHARASHTRA,31,WARDHA,201109,31121,26510,24754,62504,42782,71069,67536,133573,0,1019,0,684,0,15
3/15/2013,MAHARASHTRA,32,WASHIM,177118,69,386,12634,70915,15673,77896,28307,148811,931,570,462,581,1,0
3/15/2013,MAHARASHTRA,33,YAVATMAL,432954,49807,77417,48230,159364,65526,159834,113756,319198,155,1201,140,1222,0,4
3/15/2013,MAHARASHTRA,,"Total 
                        :-",10669811,1121757,1097120,839831,3028040,1849694,4952666,2689525,7980706,10249,50820,5846,42671,1092,1907
3/15/2013,MANIPUR,1,BISHNUPUR,26674,5304,143,330,11422,10072,4850,10402,16272,28,153,1,59,0,2
3/15/2013,MANIPUR,2,CHANDEL,18246,0,18103,3170,15076,0,0,3170,15076,0,284,0,0,0,0
3/15/2013,MANIPUR,3,CHURACHANDPUR,31265,0,31265,415,27379,241,3230,656,30609,0,1,0,1,0,0
3/15/2013,MANIPUR,4,IMPHAL EAST,44836,12,190,4291,12915,15646,11984,19937,24899,32,105,22,107,2,3
3/15/2013,MANIPUR,5,IMPHAL WEST,36184,2140,206,4386,20141,7392,4265,11778,24406,32,156,16,0,0,37
3/15/2013,MANIPUR,6,SENAPATI,51186,169,50717,10710,27838,737,11901,11447,39739,46,55,86,170,1,0
3/15/2013,MANIPUR,7,TAMENGLONG,14471,0,14471,43,13088,1001,339,1044,13427,8,80,11,0,0,2
3/15/2013,MANIPUR,8,THOUBAL,28514,0,0,0,23264,0,5250,0,28514,0,2,0,0,0,42
3/15/2013,MANIPUR,9,UKHRUL,17820,0,17820,241,12850,2209,2520,2450,15370,0,223,0,289,0,0
3/15/2013,MANIPUR,,"Total 
                        :-",269196,7625,132915,23586,163973,37298,44339,60884,208312,146,1059,136,626,3,86
3/15/2013,MEGHALAYA,1,EAST GARO HILLS,37188,0,37045,236,31282,375,5295,611,36577,14,724,2,69,0,0
3/15/2013,MEGHALAYA,2,EAST KHASI HILLS,76658,776,75825,8786,41881,15432,10559,24218,52440,314,403,159,155,7,6
3/15/2013,MEGHALAYA,3,JAINTIA HILLS,42118,2,30909,1072,32171,2151,6724,3223,38895,107,588,3,154,0,0
3/15/2013,MEGHALAYA,4,RI BHOI,35843,15,35828,22,16188,697,18936,719,35124,19,30,0,8,1,0
3/15/2013,MEGHALAYA,5,SOUTH GARO HILLS,13457,0,13451,136,11866,15,1440,151,13306,3,90,1,41,0,9
3/15/2013,MEGHALAYA,6,WEST GARO HILLS,47481,14,47330,199,44356,624,2302,823,46658,18,1305,2,447,0,2
3/15/2013,MEGHALAYA,7,WEST KHASI HILLS,42858,121,42730,1243,24604,15208,1803,16451,26407,88,393,26,176,0,6
3/15/2013,MEGHALAYA,,"Total 
                        :-",295603,928,283118,11694,202348,34502,47059,46196,249407,563,3533,193,1050,8,23
3/15/2013,MIZORAM,1,AIZAWL,10546,0,10546,0,7765,258,2523,258,10288,18,474,6,238,0,0
3/15/2013,MIZORAM,2,CHAMPHAI,13020,0,12897,0,11073,0,1947,0,13020,14,702,3,183,0,10
3/15/2013,MIZORAM,3,KOLASIB,6596,0,6596,0,6510,86,0,86,6510,0,242,0,73,0,0
3/15/2013,MIZORAM,4,LAWNGTLAI,12933,0,12933,27,11314,103,1489,130,12803,0,396,0,89,0,85
3/15/2013,MIZORAM,5,LUNGLEI,16745,0,16745,0,16120,5,620,5,16740,36,615,8,95,2,84
3/15/2013,MIZORAM,6,MAMIT,5728,0,5728,0,3752,90,1886,90,5638,2,333,7,82,0,23
3/15/2013,MIZORAM,7,SAIHA,4484,0,4484,0,4059,0,425,0,4484,0,115,0,0,0,0
3/15/2013,MIZORAM,8,SERCHHIP,5769,0,5769,0,4355,150,1264,150,5619,5,74,0,90,0,21
3/15/2013,MIZORAM,,"Total 
                        :-",75821,0,75698,27,64948,692,10154,719,75102,75,2951,24,850,2,223
3/15/2013,NAGALAND,1,DIMAPUR,12142,0,12142,1115,5055,4180,1792,5295,6847,18,79,10,58,0,0
3/15/2013,NAGALAND,2,KIPHIRE,0,0,0,0,0,0,0,0,0,0,0,0,0,0,0
3/15/2013,NAGALAND,3,KOHIMA,27688,0,27688,4542,16191,4242,2713,8784,18904,41,97,17,174,0,0
3/15/2013,NAGALAND,4,LONGLENG,0,0,0,0,0,0,0,0,0,0,0,0,0,0,0
3/15/2013,NAGALAND,5,MOKOKCHUNG,17034,0,17034,2074,7178,6145,1637,8219,8815,19,73,3,77,0,0
3/15/2013,NAGALAND,6,MON,2313,0,2313,94,1335,719,165,813,1500,7,10,2,16,0,0
3/15/2013,NAGALAND,7,PEREN,11465,0,11465,99,8312,972,2082,1071,10394,0,86,11,101,0,0
3/15/2013,NAGALAND,8,PHEK,20935,0,20935,475,18389,911,1160,1386,19549,0,138,0,88,0,2
3/15/2013,NAGALAND,9,TUENSANG,4144,0,4144,244,3308,592,0,836,3308,13,22,3,45,0,1
3/15/2013,NAGALAND,10,WOKHA,12786,0,12786,952,8608,2082,1144,3034,9752,0,108,6,54,0,3
3/15/2013,NAGALAND,11,ZUNHEBOTO,7785,0,7785,87,6251,1447,0,1534,6251,16,43,8,63,2,0
3/15/2013,NAGALAND,,"Total 
                        :-",116292,0,116292,9682,74627,21290,10693,30972,85320,114,656,60,676,2,6
3/15/2013,ORISSA,1,ANGUL,199118,0,0,10914,109581,1719,76904,12633,186485,0,2040,0,795,0,0
3/15/2013,ORISSA,2,BALANGIR,342256,0,0,0,199853,0,142403,0,342256,173,2066,0,658,0,7
3/15/2013,ORISSA,3,BALESWAR,412822,73523,45276,4041,281636,24778,102367,28819,384003,0,3025,0,1849,0,5
3/15/2013,ORISSA,4,BARGARH,278143,42362,31892,1440,174151,1532,101020,2972,275171,122,1752,4,374,0,0
3/15/2013,ORISSA,5,BHADRAK,214683,52256,4070,4816,131533,1,78333,4817,209866,3,1854,5,1049,0,0
3/15/2013,ORISSA,6,BOUDH,92921,0,0,101,71692,158,20970,259,92662,0,1033,0,258,0,0
3/15/2013,ORISSA,7,CUTTACK,371581,102,15,16299,170776,24522,159984,40821,330760,11,2424,1,42,1,8
3/15/2013,ORISSA,8,DEBAGARH,63597,15576,19361,1628,42977,438,18554,2066,61531,14,466,8,188,0,0
3/15/2013,ORISSA,9,DHENKANAL,192292,0,0,0,125111,1985,65196,1985,190307,0,2065,17,690,0,0
3/15/2013,ORISSA,10,GAJAPATI,108534,421,437,604,68154,0,39776,604,107930,0,1048,0,629,0,0
3/15/2013,ORISSA,11,GANJAM,542408,102143,15331,33305,270886,57787,180430,91092,451316,0,3527,0,2505,0,11
3/15/2013,ORISSA,12,JAGATSINGHAPUR,209819,51283,1056,381,91718,1179,116541,1560,208259,8,1605,0,929,2,7
3/15/2013,ORISSA,13,JAJAPUR,388063,0,0,13471,162457,20236,191899,33707,354356,5,3155,0,290,0,0
3/15/2013,ORISSA,14,JHARSUGUDA,67809,10724,22999,0,32957,130,34722,130,67679,570,72,367,60,0,2
3/15/2013,ORISSA,15,KALAHANDI,308027,117,330,2196,190958,9458,105415,11654,296373,0,2330,0,676,1,0
3/15/2013,ORISSA,16,KANDHAMAL,155540,46724,93361,0,112422,0,43118,0,155540,0,1812,0,937,0,0
3/15/2013,ORISSA,17,KENDRAPARA,249973,46012,1953,3115,136153,30781,79924,33896,216077,0,2140,14,1058,0,1
3/15/2013,ORISSA,18,KENDUJHAR,263398,53593,109355,0,219858,423,43117,423,262975,13,5430,0,1592,0,0
3/15/2013,ORISSA,19,KHORDHA,229568,8016,3829,20,149422,92,80034,112,229456,1,1309,1,114,0,1
3/15/2013,ORISSA,20,KORAPUT,264295,0,0,409,221421,59,42406,468,263827,0,1956,0,1107,0,9
3/15/2013,ORISSA,21,MALKANGIRI,101126,951,0,0,84917,10,16199,10,101116,0,1095,0,516,0,0
3/15/2013,ORISSA,22,MAYURBHANJ,462483,69568,246849,0,367382,0,95101,0,462483,0,4567,0,1696,0,0
3/15/2013,ORISSA,23,NABARANGAPUR,239288,58573,129381,342,158432,3759,76755,4101,235187,0,1345,0,378,0,0
3/15/2013,ORISSA,24,NAYAGARH,208917,26119,10818,738,134750,867,72562,1605,207312,0,1993,0,34,0,9
3/15/2013,ORISSA,25,NUAPADA,135405,16047,41968,2430,101474,4203,27298,6633,128772,150,941,0,585,0,0
3/15/2013,ORISSA,26,PURI,236721,44434,1256,2667,160972,2922,70160,5589,231132,0,2250,0,1130,0,19
3/15/2013,ORISSA,27,RAYAGADA,164713,33807,128896,1820,116200,9607,37086,11427,153286,283,1216,35,689,0,0
3/15/2013,ORISSA,28,SAMBALPUR,149574,19348,45708,1411,88669,5659,53835,7070,142504,0,1296,0,480,0,0
3/15/2013,ORISSA,29,SONEPUR,104662,210,106,0,80380,889,23393,889,103773,0,1470,0,187,0,0
3/15/2013,ORISSA,30,SUNDARGARH,266143,35562,179132,655,183778,2358,79352,3013,263130,0,2444,0,1391,0,3
3/15/2013,ORISSA,,"Total 
                        :-",7023879,807471,1133379,102803,4440670,205552,2274854,308355,6715524,1353,59726,452,22886,4,82
3/15/2013,PUDUCHERRY,1,PONDICHERRY,0,0,0,0,0,0,0,0,0,0,0,0,0,0,0
3/15/2013,PUDUCHERRY,,"Total 
                        :-",0,0,0,0,0,0,0,0,0,0,0,0,0,0,0
3/15/2013,PUNJAB,1,AMRITSAR,160791,55,4,10145,18790,65128,66728,75273,85518,447,56,6,61,3,0
3/15/2013,PUNJAB,2,BARNALA,60952,23910,0,4953,6818,32629,16552,37582,23370,249,0,163,154,0,0
3/15/2013,PUNJAB,3,BATHINDA,146658,14527,0,12822,1786,120453,11597,133275,13383,609,20,502,0,7,2
3/15/2013,PUNJAB,4,FARIDKOT,68126,34325,5,3771,1991,62364,0,66135,1991,93,0,45,0,2,0
3/15/2013,PUNJAB,5,FATEHGARH SAHIB,68818,0,0,3290,2464,46886,16178,50176,18642,558,0,312,0,0,0
3/15/2013,PUNJAB,6,FEROZEPUR,242789,94978,0,19166,28954,121066,73603,140232,102557,438,79,143,154,1,0
3/15/2013,PUNJAB,7,GURDASPUR,184905,4980,1,7990,41597,66521,68797,74511,110394,273,53,178,0,0,0
3/15/2013,PUNJAB,8,HOSHIARPUR,84626,419,0,3411,10922,70293,0,73704,10922,50,0,19,0,0,0
3/15/2013,PUNJAB,9,JALANDHAR,85874,26989,0,4574,1894,76698,2708,81272,4602,375,23,330,0,0,0
3/15/2013,PUNJAB,10,KAPURTHALA,18916,8151,0,1988,895,13855,2178,15843,3073,120,20,98,0,1,0
3/15/2013,PUNJAB,11,LUDHIANA,235013,69198,15,52415,42112,131788,8698,184203,50810,1022,87,785,145,18,6
3/15/2013,PUNJAB,12,MANSA,108624,37915,0,10911,16521,51516,29676,62427,46197,282,88,162,380,56,56
3/15/2013,PUNJAB,13,MOGA,8354,2311,0,1152,5,7197,0,8349,5,61,0,48,0,2,0
3/15/2013,PUNJAB,14,MUKTSAR,82242,53154,0,15542,133,66567,0,82109,133,476,0,27,0,0,0
3/15/2013,PUNJAB,15,NAWANSHAHR,74545,24900,41,2061,5994,34992,31498,37053,37492,168,0,88,0,0,0
3/15/2013,PUNJAB,16,PATIALA,115674,39156,0,6313,6376,68415,34570,74728,40946,587,0,146,416,4,0
3/15/2013,PUNJAB,17,RUPNAGAR,88517,40186,0,13745,25445,28757,20570,42502,46015,948,13,453,227,0,0
3/15/2013,PUNJAB,18,S.A.S NAGAR,33680,1014,0,3620,3632,16875,9553,20495,13185,116,6,202,0,0,0
3/15/2013,PUNJAB,19,SANGRUR,127718,45794,0,13552,19442,69164,25560,82716,45002,323,45,19,357,6,7
3/15/2013,PUNJAB,20,TARN TARAN,201948,72731,0,8936,12783,110754,69475,119690,82258,356,39,1,0,0,0
3/15/2013,PUNJAB,,"Total 
                        :-",2198770,594693,66,200357,248554,1261918,487941,1462275,736495,7551,529,3727,1894,100,71
3/15/2013,RAJASTHAN,1,AJMER,220832,35948,7100,3587,26594,44178,146473,47765,173067,1324,509,735,520,0,1
3/15/2013,RAJASTHAN,2,ALWAR,380746,87578,32297,12873,53354,37052,277467,49925,330821,1501,623,147,163,0,0
3/15/2013,RAJASTHAN,3,BANSWARA,258039,12289,183272,0,168818,9793,79428,9793,248246,149,3334,9,1183,4943,1
3/15/2013,RAJASTHAN,4,BARAN,155949,39375,29086,2,43457,0,112490,2,155947,0,1127,0,727,0,26
3/15/2013,RAJASTHAN,5,BARMER,268989,45831,18951,1,81535,16638,170815,16639,252350,575,3322,182,901,0,50
3/15/2013,RAJASTHAN,6,BHARATPUR,244373,49741,5751,45,45516,0,198812,45,244328,273,605,145,295,0,50
3/15/2013,RAJASTHAN,7,BHILWARA,261939,44844,27910,6598,72516,8614,174211,15212,246727,112,3693,11,546,14,12
3/15/2013,RAJASTHAN,8,BIKANER,221626,59693,1230,37945,51256,44293,88132,82238,139388,1125,701,464,568,52,4
3/15/2013,RAJASTHAN,9,BUNDI,161266,30663,35210,4495,28872,18258,109641,22753,138513,349,1189,26,103,1,12
3/15/2013,RAJASTHAN,10,CHITTORGARH,269032,36550,46801,5673,54415,23373,185571,29046,239986,1949,428,341,772,34,1
3/15/2013,RAJASTHAN,11,CHURU,213362,53090,2675,10464,39998,61764,101136,72228,141134,958,577,184,515,0,0
3/15/2013,RAJASTHAN,12,DAUSA,254430,35617,30540,278,43066,13064,198022,13342,241088,284,1027,11,222,0,0
3/15/2013,RAJASTHAN,13,DHOLPUR,123533,5862,56,560,19869,2673,100431,3233,120300,605,378,24,159,1,0
3/15/2013,RAJASTHAN,14,DUNGARPUR,121660,4835,74607,266,68730,15458,37206,15724,105936,4331,178,181,1138,0,9
3/15/2013,RAJASTHAN,15,GANGANAGAR,255630,78021,4915,20101,27738,109131,98660,129232,126398,707,1266,1061,360,1,0
3/15/2013,RAJASTHAN,16,HANUMANGARH,225402,63455,793,4283,31017,154535,35567,158818,66584,1267,1038,6,124,0,0
3/15/2013,RAJASTHAN,17,JAIPUR,101570,23032,17288,1943,14019,4853,80755,6796,94774,193,821,11,536,3,0
3/15/2013,RAJASTHAN,18,JAISALMER,85046,3079,1429,1178,17477,4507,61884,5685,79361,416,816,0,238,0,0
3/15/2013,RAJASTHAN,19,JALOR,219457,52172,30356,0,67713,18263,133481,18263,201194,0,2460,0,188,0,0
3/15/2013,RAJASTHAN,20,JHALAWAR,175931,41985,33628,2364,32287,13266,128014,15630,160301,1311,480,17,1097,10,0
3/15/2013,RAJASTHAN,21,JHUNJHUNU,307764,61678,7977,3858,9553,143547,150806,147405,160359,2016,91,591,739,29,0
3/15/2013,RAJASTHAN,22,JODHPUR,352069,63954,13362,0,69680,36214,246175,36214,315855,664,480,53,793,0,48
3/15/2013,RAJASTHAN,23,KARAULI,188328,52557,55227,631,59244,1532,126921,2163,186165,536,1993,0,511,0,8
3/15/2013,RAJASTHAN,24,KOTA,129910,30362,21771,1151,37430,5366,85963,6517,123393,443,1131,55,58,2,3
3/15/2013,RAJASTHAN,25,NAGAUR,436779,70972,691,13020,41200,126284,256275,139304,297475,2976,984,749,869,1,0
3/15/2013,RAJASTHAN,26,PALI,230176,66161,20078,4050,44655,58722,122749,62772,167404,804,640,312,414,0,0
3/15/2013,RAJASTHAN,27,RAJSAMAND,183194,29858,35694,5583,54624,18307,104680,23890,159304,396,1434,0,711,0,35
3/15/2013,RAJASTHAN,28,SAWAI MADHOPUR,172910,39059,45892,97,33574,2084,137155,2181,170729,417,793,17,640,0,0
3/15/2013,RAJASTHAN,29,SIKAR,326845,0,0,1065,26377,71615,227788,72680,254165,1731,257,0,0,0,10
3/15/2013,RAJASTHAN,30,SIROHI,116216,23266,34452,0,36049,722,79445,722,115494,8,58,12,133,0,0
3/15/2013,RAJASTHAN,31,TONK,185804,45853,33636,1923,30366,8439,145076,10362,175442,568,1063,83,264,0,12
3/15/2013,RAJASTHAN,32,UDAIPUR,457957,22559,238312,4514,218401,28171,206871,32685,425272,958,2495,65,1313,0,19
3/15/2013,RAJASTHAN,,"Total 
                        :-",7306764,1309939,1090987,148548,1649400,1100716,4408100,1249264,6057500,28946,35991,5492,16800,5091,301
3/15/2013,SIKKIM,1,EAST SIKKIM,42109,2271,9490,0,24109,18000,0,18000,24109,0,464,0,36,0,225
3/15/2013,SIKKIM,2,NORTH SIKKIM,6009,299,4853,0,4978,1031,0,1031,4978,0,272,0,63,0,134
3/15/2013,SIKKIM,3,SOUTH SIKKIM,16651,1527,6788,0,8970,7681,0,7681,8970,0,438,0,82,0,205
3/15/2013,SIKKIM,4,WEST SIKKIM,22245,1428,10959,0,13245,9000,0,9000,13245,0,430,0,159,0,224
3/15/2013,SIKKIM,,"Total 
                        :-",87014,5525,32090,0,51302,35712,0,35712,51302,0,1604,0,340,0,788
3/15/2013,TAMIL NADU,1,COIMBATORE,420458,109434,5554,94835,85462,143422,96739,238257,182201,1455,54,660,36,8,0
3/15/2013,TAMIL NADU,2,CUDDALORE,328393,115536,3083,144984,91351,39552,52506,184536,143857,1919,7,960,4,215,2
3/15/2013,TAMIL NADU,3,DHARMAPURI,246382,43875,9266,9981,150760,25438,60203,35419,210963,43,2064,1,590,0,0
3/15/2013,TAMIL NADU,4,DINDIGUL,364300,32790,6459,30944,63183,62882,207291,93826,270474,51,955,64,962,6,19
3/15/2013,TAMIL NADU,5,ERODE,418456,55823,3162,122472,72109,113442,110433,235914,182542,691,838,322,548,62,3
3/15/2013,TAMIL NADU,6,KANCHIPURAM,351630,103164,3706,80685,92590,130221,48134,210906,140724,233,1159,156,889,6,1
3/15/2013,TAMIL NADU,7,KANYAKUMARI(NAGERCOIL),157339,3828,991,54242,43565,52546,6986,106788,50551,167,362,667,340,0,0
3/15/2013,TAMIL NADU,8,KARUR,190023,22226,0,77627,45854,43678,22864,121305,68718,419,177,284,105,78,19
3/15/2013,TAMIL NADU,9,KRISHNAGIRI,354046,41290,3364,37857,204585,38684,72920,76541,277505,700,2132,441,431,31,15
3/15/2013,TAMIL NADU,10,MADURAI,346204,75980,466,14940,138106,84048,109110,98988,247216,140,918,107,698,62,0
3/15/2013,TAMIL NADU,11,NAGAPATTINAM,324861,109815,426,79718,55156,116336,73651,196054,128807,441,657,265,309,434,5
3/15/2013,TAMIL NADU,12,NAMAKKAL,296413,64867,17018,20251,108048,97478,70636,117729,178684,480,345,413,246,309,50
3/15/2013,TAMIL NADU,13,NILGIRIS(UDHAGAMANDALAM),93227,19877,3970,2662,39137,5263,46165,7925,85302,309,142,14,232,0,46
3/15/2013,TAMIL NADU,14,PERAMBALUR,271373,85252,2386,3514,179051,25405,63403,28919,242454,25,751,3,618,5,38
3/15/2013,TAMIL NADU,15,PUDUKKOTTAI,261027,68737,0,94606,123196,31516,11709,126122,134905,1355,216,1230,146,498,0
3/15/2013,TAMIL NADU,16,RAMANATHAPURAM,251706,65186,16,39702,104975,30902,76127,70604,181102,11,1244,2,737,0,3
3/15/2013,TAMIL NADU,17,SALEM,420822,84743,23096,56467,217776,36742,109837,93209,327613,49,1679,33,923,1,0
3/15/2013,TAMIL NADU,18,SIVAGANGA,245067,47024,52,57078,119466,38525,29998,95603,149464,725,149,421,158,0,0
3/15/2013,TAMIL NADU,19,THANJAVUR,367816,2499,24,38254,173769,58866,96927,97120,270696,336,2,239,2,453,0
3/15/2013,TAMIL NADU,20,THENI,142295,38509,568,34902,34568,41046,31779,75948,66347,393,5,445,36,232,0
3/15/2013,TAMIL NADU,21,THOOTHUKUDI,276025,71915,537,42857,91637,30417,111114,73274,202751,354,235,4,647,422,2
3/15/2013,TAMIL NADU,22,TIRUCHIRAPPALLI,333944,75701,3150,63322,77672,69458,123492,132780,201164,625,411,430,437,51,0
3/15/2013,TAMIL NADU,23,TIRUNELVELI,309987,83603,608,90113,27037,117187,75650,207300,102687,177,391,251,592,18,0
3/15/2013,TAMIL NADU,24,TIRUVALLUR,328105,100686,8679,61731,134609,73690,58075,135421,192684,260,889,244,947,539,1
3/15/2013,TAMIL NADU,25,TIRUVANNAMALAI,484068,102849,17462,101674,147204,71599,163591,173273,310795,1835,12,1090,5,30,0
3/15/2013,TAMIL NADU,26,TIRUVARUR,210668,76866,618,52246,41677,79618,37127,131864,78804,714,33,513,25,0,0
3/15/2013,TAMIL NADU,27,VELLORE,513883,133795,16312,53861,155289,25302,279431,79163,434720,465,2943,25,1439,2,0
3/15/2013,TAMIL NADU,28,VILLUPURAM,621893,185010,19342,133405,326185,36933,125370,170338,451555,1832,445,1526,724,103,1
3/15/2013,TAMIL NADU,29,VIRUDHUNAGAR,297026,94002,101,86610,37122,109493,63801,196103,100923,998,90,596,90,26,56
3/15/2013,TAMIL NADU,,"Total 
                        :-",9227437,2114882,150416,1781540,3181139,1829689,2435069,3611229,5616208,17202,19305,11406,12916,3591,261
3/15/2013,TRIPURA,1,DHALAI,81660,15452,47754,52232,988,21804,6636,74036,7624,481,165,325,644,0,0
3/15/2013,TRIPURA,2,NORTH TRIPURA,81457,19596,29128,64360,2599,14488,10,78848,2609,664,400,523,632,79,55
3/15/2013,TRIPURA,3,SOUTH TRIPURA,197094,31838,76067,112566,27519,45445,11564,158011,39083,779,58,1656,200,49,0
3/15/2013,TRIPURA,4,WEST TRIPURA,257208,45192,74098,52884,116788,68758,18778,121642,135566,251,872,186,1343,4,0
3/15/2013,TRIPURA,,"Total 
                        :-",617419,112078,227047,282042,147894,150495,36988,432537,184882,2175,1495,2690,2819,132,55
3/15/2013,UTTAR PRADESH,1,AGRA,330498,83118,171,34671,48345,37577,209905,72248,258250,469,624,286,845,2,2
3/15/2013,UTTAR PRADESH,2,ALIGARH,333729,88583,0,35809,73936,31855,192129,67664,266065,851,995,408,920,0,0
3/15/2013,UTTAR PRADESH,3,ALLAHABAD,657927,159913,172,28897,181311,7159,440560,36056,621871,82,2644,99,2219,3,20
3/15/2013,UTTAR PRADESH,4,AMBEDKAR NAGAR,278288,86227,5,9434,132725,9092,127037,18526,259762,121,1334,23,1350,2,18
3/15/2013,UTTAR PRADESH,5,AURAIYA,181453,59054,1056,11920,79095,9145,81293,21065,160388,62,736,8,544,0,6
3/15/2013,UTTAR PRADESH,6,AZAMGARH,560095,178179,31,34898,178967,35634,310596,70532,489563,923,2443,18,2296,3,86
3/15/2013,UTTAR PRADESH,7,BAGPAT,165832,21941,33,13731,26144,65852,60105,79583,86249,17,416,15,263,0,11
3/15/2013,UTTAR PRADESH,8,BAHRAICH,432146,72172,1349,48332,187920,27021,168873,75353,356793,1011,1451,2,1802,0,0
3/15/2013,UTTAR PRADESH,9,BALLIA,321828,63080,5838,86065,91038,42130,102595,128195,193633,149,3443,98,1085,9,107
3/15/2013,UTTAR PRADESH,10,BALRAMPUR,227461,41123,2458,17529,65161,8400,136371,25929,201532,553,1245,13,1191,1,18
3/15/2013,UTTAR PRADESH,11,BANDA,240409,53114,0,16589,120442,24706,78672,41295,199114,80,1698,2,948,1,10
3/15/2013,UTTAR PRADESH,12,BARABANKI,501928,145161,239,59333,199418,5065,238112,64398,437530,603,1832,21,1768,0,21
3/15/2013,UTTAR PRADESH,13,BAREILLY,411568,55510,73,31392,110000,73473,196703,104865,306703,350,4142,12,1619,4,14
3/15/2013,UTTAR PRADESH,14,BASTI,335317,82123,79,25133,160471,29309,120404,54442,280875,22,1643,24,1807,5,21
3/15/2013,UTTAR PRADESH,15,BIJNOR,426234,102478,538,11215,105462,87778,221779,98993,327241,3,2090,8,1390,0,68
3/15/2013,UTTAR PRADESH,16,BUDAUN,322879,79545,0,4458,102491,14018,201912,18476,304403,17,3805,4,1456,11,152
3/15/2013,UTTAR PRADESH,17,BULANDSHAHR,353414,35887,0,27322,28885,76917,220290,104239,249175,2075,2045,1381,1366,9,8
3/15/2013,UTTAR PRADESH,18,CHANDAULI,227181,68730,0,12276,91959,15340,107606,27616,199565,29,1310,4,1101,1,22
3/15/2013,UTTAR PRADESH,19,CHITRAKOOT,133803,30849,0,8071,39260,15777,70695,23848,109955,725,308,337,46,0,0
3/15/2013,UTTAR PRADESH,20,DEORIA,360473,58997,0,69203,95410,40401,155459,109604,250869,243,1914,57,1025,16,17
3/15/2013,UTTAR PRADESH,21,ETAH,192590,35592,0,10638,31052,8447,142453,19085,173505,624,842,2,1035,0,0
3/15/2013,UTTAR PRADESH,22,ETAWAH,202288,40078,41,15559,62657,22936,101136,38495,163793,637,415,42,611,0,36
3/15/2013,UTTAR PRADESH,23,FAIZABAD,232942,62987,0,23405,96565,7033,105939,30438,202504,563,608,10,1083,1,0
3/15/2013,UTTAR PRADESH,24,FARRUKHABAD,213527,27154,0,19385,119558,20391,54193,39776,173751,742,689,154,1201,2,1
3/15/2013,UTTAR PRADESH,25,FATEHPUR,366330,70721,0,47621,104426,24927,189353,72548,293779,410,950,93,1283,0,15
3/15/2013,UTTAR PRADESH,26,FIROZABAD,240982,90517,107,12280,19157,28021,181524,40301,200681,605,1537,34,973,0,10
3/15/2013,UTTAR PRADESH,27,GAUTAM BUDDHA NAGAR,107676,20375,0,4551,14569,30249,58307,34800,72876,16,383,12,373,0,0
3/15/2013,UTTAR PRADESH,28,GHAZIABAD,207321,44077,0,26902,10570,84706,85143,111608,95713,29,1571,136,612,0,5
3/15/2013,UTTAR PRADESH,29,GHAZIPUR,473686,99420,0,37769,124542,35189,276233,72958,400775,21,1754,4,1458,56,14
3/15/2013,UTTAR PRADESH,30,GONDA,350153,49087,111,14105,136500,11783,187765,25888,324265,26,1864,4,1483,0,16
3/15/2013,UTTAR PRADESH,31,GORAKHPUR,524606,125752,57,85081,149342,85019,205164,170100,354506,54,1246,32,1199,20,85
3/15/2013,UTTAR PRADESH,32,HAMIRPUR,202392,54240,0,11222,101096,15114,74960,26336,176056,38,971,0,707,0,0
3/15/2013,UTTAR PRADESH,33,HARDOI,516248,109159,0,39003,197782,52152,227311,91155,425093,750,1344,17,1555,0,4
3/15/2013,UTTAR PRADESH,34,JALAUN,166186,47655,0,30149,41153,25947,68937,56096,110090,139,1370,0,873,0,0
3/15/2013,UTTAR PRADESH,35,JAUNPUR,600402,127093,28,54361,172782,72513,300746,126874,473528,3,2622,1,3400,0,125
3/15/2013,UTTAR PRADESH,36,JHANSI,182041,66697,877,28525,58407,17200,77909,45725,136316,653,498,8,906,1,18
3/15/2013,UTTAR PRADESH,37,JYOTIBA PHULE NAGAR,197490,40531,59,22887,46148,47121,81334,70008,127482,620,413,10,471,7,0
3/15/2013,UTTAR PRADESH,38,KANNAUJ,218320,35081,8,7837,64935,52017,93531,59854,158466,47,940,24,714,2,37
3/15/2013,UTTAR PRADESH,39,KANPUR DEHAT,269391,69779,8,24783,120079,20169,104360,44952,224439,607,1093,0,1027,49,52
3/15/2013,UTTAR PRADESH,40,KANPUR NAGAR,225780,65412,202,30384,86905,17378,91113,47762,178018,838,617,38,762,0,39
3/15/2013,UTTAR PRADESH,41,KANSHIRAM NAGAR,139082,30794,0,10986,33213,4191,90692,15177,123905,586,1087,2,760,0,0
3/15/2013,UTTAR PRADESH,42,KAUSHAMBI,271743,83289,0,27861,111870,14310,117702,42171,229572,36,729,12,263,0,22
3/15/2013,UTTAR PRADESH,43,KUSHINAGAR,478938,69342,0,88685,221543,61895,106815,150580,328358,119,1987,85,2130,3,25
3/15/2013,UTTAR PRADESH,44,LAKHIMPUR KHERI,274183,98233,2779,43970,72979,33691,123543,77661,196522,968,2154,35,1089,0,20
3/15/2013,UTTAR PRADESH,45,LALITPUR,152456,46049,95,17050,84358,4038,47010,21088,131368,237,981,10,562,2,0
3/15/2013,UTTAR PRADESH,46,LUCKNOW,214520,30674,0,20410,83428,22951,87731,43361,171159,76,1418,2,1220,1,23
3/15/2013,UTTAR PRADESH,47,MAHAMAYA NAGAR(HATHRAS),184413,52046,0,17967,25133,12253,129060,30220,154193,4,1046,0,993,0,10
3/15/2013,UTTAR PRADESH,48,MAHARAJGANJ,299071,0,0,27271,142669,18515,110616,45786,253285,5,1426,3,1402,0,53
3/15/2013,UTTAR PRADESH,49,MAHOBA,118321,34627,62,6915,53102,8976,49328,15891,102430,317,860,127,464,0,0
3/15/2013,UTTAR PRADESH,50,MAINPURI,232290,45972,0,23213,84251,18887,105939,42100,190190,928,750,10,1302,7,10
3/15/2013,UTTAR PRADESH,51,MATHURA,230419,50818,0,12287,25005,13578,179549,25865,204554,5,1040,2,608,0,10
3/15/2013,UTTAR PRADESH,52,MAU,242055,70037,0,40476,112003,21109,68467,61585,180470,96,887,286,804,0,13
3/15/2013,UTTAR PRADESH,53,MEERUT,233592,54899,0,22203,23645,68359,119385,90562,143030,293,820,597,714,2,25
3/15/2013,UTTAR PRADESH,54,MIRZAPUR,322511,85897,0,10023,165200,9078,138210,19101,303410,32,1614,4,1199,33,109
3/15/2013,UTTAR PRADESH,55,MORADABAD,539172,83226,0,27217,75794,83713,352448,110930,428242,1043,1629,232,1981,3,0
3/15/2013,UTTAR PRADESH,56,MUZAFFARNAGAR,406511,82977,37,17865,51570,99801,237275,117666,288845,2,1699,7,2069,0,14
3/15/2013,UTTAR PRADESH,57,PILIBHIT,241953,48944,439,11605,95178,27976,107194,39581,202372,26,1389,4,883,0,21
3/15/2013,UTTAR PRADESH,58,PRATAPGARH,459422,121011,167,84931,104163,13834,256494,98765,360657,36,2381,88,1955,72,50
3/15/2013,UTTAR PRADESH,59,RAE BARELI,501603,61375,6,90014,180098,95631,135860,185645,315958,30,2036,11,1859,7,25
3/15/2013,UTTAR PRADESH,60,RAMPUR,247909,18151,0,39212,56944,49907,101846,89119,158790,41,633,3,229,1,0
3/15/2013,UTTAR PRADESH,61,SAHARANPUR,372051,55400,0,33484,47452,100044,191071,133528,238523,1129,3135,701,1069,4,22
3/15/2013,UTTAR PRADESH,62,SANT KABIR NAGAR,251528,53775,0,15275,120090,7704,108459,22979,228549,571,1182,2,988,0,0
3/15/2013,UTTAR PRADESH,63,SANT RAVIDAS NAGAR( BHADOHI),173935,40540,0,6486,67485,9812,90152,16298,157637,1,810,0,902,2,27
3/15/2013,UTTAR PRADESH,64,SHAHJAHANPUR,337751,111423,147,21418,185712,16455,114166,37873,299878,1281,4846,63,1347,6,10
3/15/2013,UTTAR PRADESH,65,SHRAVASTI,166343,28934,1364,5453,104820,2465,53605,7918,158425,0,908,0,647,2,3
3/15/2013,UTTAR PRADESH,66,SIDDHARTHNAGAR,330895,57919,78,28623,128038,41365,132869,69988,260907,60,1376,14,1250,0,49
3/15/2013,UTTAR PRADESH,67,SITAPUR,588499,225575,145,45877,301615,21983,219031,67860,520646,2528,2900,1063,1020,6,23
3/15/2013,UTTAR PRADESH,68,SONBHADRA,264203,110747,10108,13252,138160,10323,102468,23575,240628,3,1178,0,575,2,7
3/15/2013,UTTAR PRADESH,69,SULTANPUR,422859,120525,0,6747,162406,10296,243410,17043,405816,238,3557,8,1962,4,40
3/15/2013,UTTAR PRADESH,70,UNNAO,411469,146861,20,30697,229568,16305,134899,47002,364467,56,2259,42,1554,14,20
3/15/2013,UTTAR PRADESH,71,VARANASI,301496,45121,350,26358,85530,36728,152880,63086,238410,346,551,267,430,1,1
3/15/2013,UTTAR PRADESH,,"Total 
                        :-",21904007,5012372,29337,2006556,7249687,2291134,10356681,4297690,17606368,26900,107113,7121,80997,377,1690
3/15/2013,UTTARAKHAND,1,ALMORA,131720,27560,2,11129,45433,27018,48140,38147,93573,1057,214,27,237,0,32
3/15/2013,UTTARAKHAND,2,BAGESHWAR,52464,14503,14,4728,21322,9908,16506,14636,37828,327,98,104,98,0,4
3/15/2013,UTTARAKHAND,3,CHAMOLI,59484,10313,1539,4111,24392,9686,21295,13797,45687,430,112,256,1,0,0
3/15/2013,UTTARAKHAND,4,CHAMPAWAT,39557,7840,30,1698,22991,5784,9084,7482,32075,185,356,56,62,0,3
3/15/2013,UTTARAKHAND,5,DEHRADUN,111875,18854,16814,18646,37212,31554,24463,50200,61675,620,497,590,10,0,0
3/15/2013,UTTARAKHAND,6,HARIDWAR,188303,51507,0,42288,42458,29984,73573,72272,116031,175,133,75,19,1,11
3/15/2013,UTTARAKHAND,7,NAINITAL,96181,22652,421,9396,14314,46500,25971,55896,40285,990,205,137,95,0,0
3/15/2013,UTTARAKHAND,8,PAURI(GARHWAL),124334,18690,233,8080,52168,26940,37146,35020,89314,354,427,28,173,0,7
3/15/2013,UTTARAKHAND,9,PITHORAGARH,89638,20195,3905,4925,41110,14350,29253,19275,70363,77,334,74,215,0,8
3/15/2013,UTTARAKHAND,10,RUDRAPRAYAG,45095,6336,12,2739,13146,6889,22321,9628,35467,17,87,0,112,2,16
3/15/2013,UTTARAKHAND,11,TEHRI GARHWAL,117127,13748,4,8226,48647,25674,34580,33900,83227,881,307,118,101,0,0
3/15/2013,UTTARAKHAND,12,UDHAM SINGH NAGAR,139394,28792,18088,10020,39060,31024,59290,41044,98350,417,114,82,87,0,0
3/15/2013,UTTARAKHAND,13,UTTARKASHI,57314,15106,154,3107,28143,5364,20700,8471,48843,613,240,123,33,0,0
3/15/2013,UTTARAKHAND,,"Total 
                        :-",1252486,256096,41216,129093,430396,270675,422322,399768,852718,6143,3124,1670,1243,3,81
3/15/2013,WEST BENGAL,1,BANKURA,753160,165394,55544,86885,194652,137791,333832,224676,528484,1962,4880,387,4130,16,26
3/15/2013,WEST BENGAL,2,BARDHAMAN,1168874,301072,101750,51005,581608,237094,299167,288099,880775,2119,2929,2867,2834,0,0
3/15/2013,WEST BENGAL,3,BIRBHUM,638882,189367,50049,58015,233218,77461,270188,135476,503406,2124,630,146,1954,2,0
3/15/2013,WEST BENGAL,4,COOCH BEHAR,642154,386375,2475,58331,296443,54366,233014,112697,529457,2249,1251,979,775,28,39
3/15/2013,WEST BENGAL,5,DAKSHIN DINAJPUR,390150,80963,78079,9767,171601,29460,179322,39227,350923,283,1544,0,1127,0,0
3/15/2013,WEST BENGAL,6,DARJEELING,122417,9004,28771,10039,66648,16728,29002,26767,95650,0,1784,0,408,0,50
3/15/2013,WEST BENGAL,7,HOOGHLY,816062,244971,48414,51882,271737,296933,195510,348815,467247,427,5226,741,3350,0,15
3/15/2013,WEST BENGAL,8,HOWRAH,575268,0,0,62991,168925,211098,132254,274089,301179,163,1859,140,2185,0,0
3/15/2013,WEST BENGAL,9,JALPAIGURI,587157,224121,122209,53996,285494,86521,161146,140517,446640,738,1797,0,573,0,0
3/15/2013,WEST BENGAL,10,MALDA,622866,81157,30955,12898,292861,55332,261775,68230,554636,537,1226,64,96,0,1
3/15/2013,WEST BENGAL,11,MIDNAPUR EAST,783080,127612,7491,195103,331211,228230,28536,423333,359747,55,969,22,321,15,0
3/15/2013,WEST BENGAL,12,MIDNAPUR WEST,1048085,182530,127857,71500,474352,141966,360267,213466,834619,648,12475,497,5332,0,33
3/15/2013,WEST BENGAL,13,MURSHIDABAD,1358338,139770,23699,36866,682191,141835,497446,178701,1179637,381,9119,0,6298,0,0
3/15/2013,WEST BENGAL,14,NADIA,899402,109774,16342,81866,308017,249621,259898,331487,567915,2061,6127,529,5078,26,18
3/15/2013,WEST BENGAL,15,NORTH 24 PARAGANAS,876571,255634,43645,94245,313983,246664,221679,340909,535662,325,6013,370,4140,0,20
3/15/2013,WEST BENGAL,16,PURULIA,537324,14154,17446,1581,210168,18642,306933,20223,517101,1357,7239,5,4023,0,4
3/15/2013,WEST BENGAL,17,SILIGURI,116350,42627,24920,10847,59425,20991,25087,31838,84512,0,671,16,1325,7,24
3/15/2013,WEST BENGAL,18,SOUTH 24 PARAGANAS,1480469,369611,13887,107603,628712,222962,521192,330565,1149904,1202,3019,146,3768,18,10
3/15/2013,WEST BENGAL,19,UTTAR DINAJPUR,559945,180013,36467,522,256943,1545,300935,2067,557878,297,2214,14,1556,0,50
3/15/2013,WEST BENGAL,,"Total 
                        :-",13976554,3104149,830000,1055942,5828189,2475240,4617183,3531182,10445372,16928,70972,6923,49273,112,290
