Date,State,Serial,District,HH_PER-BASE_TOTAL,HH_PER-BASE_SC,HH_PER-BASE_ST,BPL_WT,BPL_WOT,APL_WT,APL_WOT,APL+BPL_WT,APL+BPL_WOT,SCH_WT,SCH_WOT,ANGAN_WT,ANGAN_WOT,SAN_WT,SAN_WOT
3/8/2013,ANDHRA PRADESH,1,ADILABAD,406468,77928,72158,13312,261726,4528,126578,17840,388304,324,1015,121,306,0,0
3/8/2013,ANDHRA PRADESH,2,ANANTAPUR,715128,68153,22310,274192,246023,101502,93411,375694,339434,2233,622,243,283,8,0
3/8/2013,ANDHRA PRADESH,3,CHITTOOR,605121,156660,37265,190200,295716,73042,46163,263242,341879,2786,1899,308,361,0,0
3/8/2013,ANDHRA PRADESH,4,CUDDAPAH,467792,90250,18600,166663,251494,23065,26570,189728,278064,2913,1732,403,238,0,0
3/8/2013,ANDHRA PRADESH,5,EAST GODAVARI,1066661,215894,47999,219974,303755,393587,149345,613561,453100,1736,2117,771,931,6,42
3/8/2013,ANDHRA PRADESH,6,GUNTUR,782238,155032,39795,180184,367363,94379,140312,274563,507675,2508,1173,300,214,1,0
3/8/2013,ANDHRA PRADESH,7,KARIMNAGAR,689887,132072,24393,71358,311460,172056,135013,243414,446473,749,2314,285,271,0,0
3/8/2013,ANDHRA PRADESH,8,KHAMMAM,554816,100518,161491,264529,183431,102794,4171,367323,187602,3112,39,787,428,1,0
3/8/2013,ANDHRA PRADESH,9,KRISHNA,751132,154600,25810,67505,351572,238669,93386,306174,444958,1525,3374,429,62,0,1
3/8/2013,ANDHRA PRADESH,10,KURNOOL,588903,118755,13540,113630,312183,35046,128044,148676,440227,1493,918,0,421,19,0
3/8/2013,ANDHRA PRADESH,11,MAHBUBNAGAR,622104,71884,112368,116059,415768,40090,50187,156149,465955,1460,1136,38,124,0,0
3/8/2013,ANDHRA PRADESH,12,MEDAK,439672,101701,30220,93949,311743,22094,11886,116043,323629,1766,1063,375,940,2,0
3/8/2013,ANDHRA PRADESH,13,NALGONDA,599022,40875,14035,151076,214790,103578,129578,254654,344368,1915,1368,588,43,0,0
3/8/2013,ANDHRA PRADESH,14,NELLORE,462284,117945,58015,88440,226725,35594,111525,124034,338250,2747,340,559,362,3,0
3/8/2013,ANDHRA PRADESH,15,NIZAMABAD,477685,57733,15834,123201,225519,119491,9474,242692,234993,1039,1438,401,32,0,0
3/8/2013,ANDHRA PRADESH,16,PRAKASAM,687083,136917,25639,76962,252004,206763,151354,283725,403358,2188,1070,578,80,0,0
3/8/2013,ANDHRA PRADESH,17,RANGAREDDI,378238,76675,24516,110984,170921,68327,28006,179311,198927,796,575,349,466,0,0
3/8/2013,ANDHRA PRADESH,18,SRIKAKULAM,560858,49017,28719,62347,302221,25155,171135,87502,473356,306,1176,17,259,0,1
3/8/2013,ANDHRA PRADESH,19,VISAKHAPATNAM,588402,185782,154403,141743,252749,41633,152277,183376,405026,1475,4495,243,0,2,0
3/8/2013,ANDHRA PRADESH,20,VIZIANAGARAM,475573,49897,42960,90892,193302,14171,177208,105063,370510,559,146,86,0,0,4
3/8/2013,ANDHRA PRADESH,21,WARANGAL,205322,192120,137555,83572,75577,26776,19397,110348,94974,207,2104,93,65,1,0
3/8/2013,ANDHRA PRADESH,22,WEST GODAVARI,887247,161390,18632,277550,252275,229183,128239,506733,380514,904,1694,434,151,134,385
3/8/2013,ANDHRA PRADESH,,"Total 
                        :-",13011636,2511798,1126257,2978322,5778317,2171523,2083259,5149845,7861576,34741,31808,7408,6037,177,433
3/8/2013,ARUNACHAL PRADESH,1,ANJAW,3893,0,3893,661,3232,0,0,661,3232,17,37,0,33,0,0
3/8/2013,ARUNACHAL PRADESH,2,CHANGLANG,9971,0,9318,138,7035,2777,21,2915,7056,0,193,0,250,0,25
3/8/2013,ARUNACHAL PRADESH,3,DIBANG VALLEY,1081,4,975,0,1081,0,0,0,1081,15,9,0,0,0,0
3/8/2013,ARUNACHAL PRADESH,4,EAST KAMENG,8225,0,0,1943,3463,2688,131,4631,3594,0,1,0,2,0,0
3/8/2013,ARUNACHAL PRADESH,5,EAST SIANG,8853,0,8853,0,8020,145,688,145,8708,5,46,0,42,6,0
3/8/2013,ARUNACHAL PRADESH,6,KURUNG KUMEY,17061,0,17058,0,17024,37,0,37,17024,12,115,0,0,0,0
3/8/2013,ARUNACHAL PRADESH,7,LOHIT,11999,0,11999,824,8138,3037,0,3861,8138,21,129,22,159,0,7
3/8/2013,ARUNACHAL PRADESH,8,LOWER DIBANG VALLEY,3602,0,3602,869,1494,382,857,1251,2351,54,7,67,8,0,0
3/8/2013,ARUNACHAL PRADESH,9,LOWER SUBANSIRI,8543,0,8543,414,5766,1199,1164,1613,6930,0,123,1,119,0,10
3/8/2013,ARUNACHAL PRADESH,10,PAPUM PARE,1257,0,6928,0,1257,0,0,0,1257,151,58,122,42,0,0
3/8/2013,ARUNACHAL PRADESH,11,TAWANG,5705,0,5555,0,4019,496,1190,496,5209,6,86,1,13,2,0
3/8/2013,ARUNACHAL PRADESH,12,TIRAP,14322,0,14322,8344,5494,383,101,8727,5595,0,254,0,150,0,0
3/8/2013,ARUNACHAL PRADESH,13,UPPER SIANG,4087,0,4087,213,2560,350,964,563,3524,5,76,2,50,0,2
3/8/2013,ARUNACHAL PRADESH,14,UPPER SUBANSIRI,9013,0,9013,23,8989,0,1,23,8990,53,154,2,221,0,0
3/8/2013,ARUNACHAL PRADESH,15,WEST KAMENG,6549,0,6549,751,4961,600,237,1351,5198,191,0,107,4,2,2
3/8/2013,ARUNACHAL PRADESH,16,WEST SIANG,12871,0,12851,29,11447,1395,0,1424,11447,2,255,6,1,0,0
3/8/2013,ARUNACHAL PRADESH,,"Total 
                        :-",127032,4,123546,14209,93980,13489,5354,27698,99334,532,1543,330,1094,10,46
3/8/2013,ASSAM,1,BAGSHA,5005,235,282,0,1450,3019,536,3019,1986,24,12,0,28,0,0
3/8/2013,ASSAM,2,BARPETA,216871,0,0,0,106487,17315,93069,17315,199556,104,1806,1,175,0,0
3/8/2013,ASSAM,3,BONGAIGAON,95653,10313,3437,2015,51929,10185,31524,12200,83453,229,1222,4,59,0,0
3/8/2013,ASSAM,4,CACHAR,180958,33496,7150,2104,119931,12630,46293,14734,166224,70,1839,0,1697,0,0
3/8/2013,ASSAM,5,DARRANG,113721,5810,5567,0,79139,9641,24941,9641,104080,0,673,0,243,0,0
3/8/2013,ASSAM,6,DHEMAJI,104463,225,2262,715,80854,4513,18381,5228,99235,29,850,0,230,0,0
3/8/2013,ASSAM,7,DHUBRI,271266,6989,2150,1713,194324,39172,36057,40885,230381,460,1012,44,576,0,0
3/8/2013,ASSAM,8,DIBRUGARH,202039,6267,21338,2650,57122,96883,45384,99533,102506,219,969,28,606,0,0
3/8/2013,ASSAM,9,GOALPARA,89251,5922,16952,1317,65070,6064,16800,7381,81870,87,1840,175,804,0,0
3/8/2013,ASSAM,10,GOLAGHAT,122906,8602,10650,7486,79743,8646,27031,16132,106774,90,1086,46,119,0,0
3/8/2013,ASSAM,11,HAILAKANDI,64396,5425,257,472,49837,1642,12445,2114,62282,2,1126,0,35,0,0
3/8/2013,ASSAM,12,JORHAT,129054,13261,17504,11512,58739,37056,21747,48568,80486,601,1609,417,951,0,0
3/8/2013,ASSAM,13,KAMRUP,230279,29712,25829,32686,85783,60425,51385,93111,137168,1455,442,40,1531,12,0
3/8/2013,ASSAM,14,KARBI ANGLONG,0,0,0,0,0,0,0,0,0,0,0,0,0,0,0
3/8/2013,ASSAM,15,KARIMGANJ,97153,1264,12,275,78992,2477,15409,2752,94401,360,1051,0,912,0,0
3/8/2013,ASSAM,16,KOKRAJHAR,33387,1356,12783,56,17284,7725,8322,7781,25606,11,293,0,63,0,0
3/8/2013,ASSAM,17,LAKHIMPUR,126421,13329,33431,16063,73224,14452,22682,30515,95906,286,1415,4,268,0,0
3/8/2013,ASSAM,18,MARIGAON,133883,120,270,0,59634,560,73689,560,133323,0,300,0,750,0,0
3/8/2013,ASSAM,19,NAGAON,242531,29337,16592,6343,159312,26199,50677,32542,209989,10,2468,72,591,2,0
3/8/2013,ASSAM,20,NALBARI,127388,5689,2605,121,79902,8939,38426,9060,118328,780,282,0,710,0,0
3/8/2013,ASSAM,21,SIBSAGAR,150631,5680,5903,4083,74272,22339,49937,26422,124209,382,2102,21,922,0,0
3/8/2013,ASSAM,22,SONITPUR,230738,13216,23141,17735,119266,36701,57036,54436,176302,442,1951,87,606,0,1
3/8/2013,ASSAM,23,TINSUKIA,167396,6892,11520,874,67748,69075,29699,69949,97447,309,859,0,595,0,0
3/8/2013,ASSAM,24,UDALGURI,0,0,0,0,0,0,0,0,0,0,0,0,0,0,0
3/8/2013,ASSAM,,"Total 
                        :-",3135390,203140,219635,108220,1760042,495658,771470,603878,2531512,5950,25207,939,12471,14,1
3/8/2013,BIHAR,1,ARARIA,174614,0,0,0,99900,520,74194,520,174094,0,1354,0,0,0,0
3/8/2013,BIHAR,2,ARWAL,96134,0,0,1866,49621,1621,43026,3487,92647,11,374,0,0,0,0
3/8/2013,BIHAR,3,AURANGABAD,213913,0,0,0,123115,408,90390,408,213505,4,7,2,0,0,0
3/8/2013,BIHAR,4,BANKA,86663,57482,1115,1788,81907,2968,0,4756,81907,32,926,52,7,27,2
3/8/2013,BIHAR,5,BEGUSARAI,410947,77164,87,9297,191885,24279,185486,33576,377371,44,479,60,192,9,12
3/8/2013,BIHAR,6,BHAGALPUR,340102,0,0,7061,148238,2292,182511,9353,330749,5,1368,0,11,0,0
3/8/2013,BIHAR,7,BHOJPUR,313835,0,0,5418,163607,26487,118323,31905,281930,65,1390,36,160,0,0
3/8/2013,BIHAR,8,BUXAR,167724,0,0,1275,77997,16722,71730,17997,149727,441,348,8,0,0,0
3/8/2013,BIHAR,9,DARBHANGA,641347,0,0,12056,346712,7325,275254,19381,621966,578,892,76,820,0,0
3/8/2013,BIHAR,10,GAYA,444020,9024,0,13378,295570,25417,109655,38795,405225,529,1778,12,151,0,0
3/8/2013,BIHAR,11,GOPALGANJ,222302,0,0,4440,145598,16128,56136,20568,201734,11,1135,21,71,0,8
3/8/2013,BIHAR,12,JAMUI,237566,69095,16919,102,108718,11331,117415,11433,226133,3,158,1,77,0,0
3/8/2013,BIHAR,13,JEHANABAD,94239,468,0,1167,51868,2853,38351,4020,90219,7,55,0,25,0,1
3/8/2013,BIHAR,14,KAIMUR(BHABUA),158260,0,0,555,79620,8676,69409,9231,149029,15,0,0,0,0,0
3/8/2013,BIHAR,15,KATIHAR,423393,0,0,2632,252534,18326,149901,20958,402435,0,1198,0,86,0,51
3/8/2013,BIHAR,16,KHAGARIA,253911,1202,0,23573,118764,48350,63224,71923,181988,269,411,56,0,0,0
3/8/2013,BIHAR,17,KISHANGANJ,232581,12786,8399,0,107253,10391,114937,10391,222190,112,1223,0,100,0,50
3/8/2013,BIHAR,18,LAKHISARAI,128624,24762,1587,464,73964,9753,44443,10217,118407,314,293,0,0,0,0
3/8/2013,BIHAR,19,MADHEPURA,259483,4267,6870,27666,106730,26850,98237,54516,204967,175,18,39,27,0,0
3/8/2013,BIHAR,20,MADHUBANI,148945,26934,0,3418,67429,8397,69701,11815,137130,703,894,9,0,3,0
3/8/2013,BIHAR,21,MUNGER,162640,0,0,13770,85688,18184,44998,31954,130686,0,272,0,0,0,0
3/8/2013,BIHAR,22,MUZAFFARPUR,707866,0,0,44642,328425,58363,276436,103005,604861,37,221,266,0,0,0
3/8/2013,BIHAR,23,NALANDA,318434,39515,0,3828,151973,5065,157568,8893,309541,878,911,29,187,11,0
3/8/2013,BIHAR,24,NAWADA,229485,149122,10,7421,141019,13059,67986,20480,209005,111,672,3,499,0,50
3/8/2013,BIHAR,25,PASHCHIM CHAMPARAN,239032,494,3,6077,219036,3281,10638,9358,229674,197,34,24,252,0,0
3/8/2013,BIHAR,26,PATNA,496779,85641,8,43967,194494,66648,191670,110615,386164,12,2710,0,213,0,0
3/8/2013,BIHAR,27,PURBA CHAMPARAN,654777,131351,0,106901,285403,17533,244940,124434,530343,374,1623,0,6,0,43
3/8/2013,BIHAR,28,PURNIA,455203,55489,20257,432,171263,14170,269338,14602,440601,251,1140,9,83,0,49
3/8/2013,BIHAR,29,SAHARSA,122592,589,6,7950,101291,4969,8382,12919,109673,4,745,1,2,0,0
3/8/2013,BIHAR,30,SAMASTIPUR,598491,0,11,21879,315594,20196,240822,42075,556416,618,10,176,406,0,0
3/8/2013,BIHAR,31,SARAN,490502,5101,0,2520,189453,17420,281109,19940,470562,76,38,152,0,0,0
3/8/2013,BIHAR,32,SASARAM(ROHTAS),361705,57982,2292,3842,179343,4135,174385,7977,353728,344,1565,1,264,0,5
3/8/2013,BIHAR,33,SHEIKHPURA,72912,25873,22,2740,43575,6332,20265,9072,63840,0,0,1,55,3,0
3/8/2013,BIHAR,34,SHEOHAR,100210,0,0,52,56915,486,42757,538,99672,5,265,0,2,1,47
3/8/2013,BIHAR,35,SITAMARHI,142438,3491,519,250,32430,1001,108757,1251,141187,34,1290,7,30,1,49
3/8/2013,BIHAR,36,SIWAN,383108,0,0,5599,233045,7839,136625,13438,369670,18,1356,0,16,0,0
3/8/2013,BIHAR,37,SUPAUL,291996,50256,1149,0,155557,11,136428,11,291985,3,996,0,8,0,0
3/8/2013,BIHAR,38,VAISHALI,373041,0,0,140,183843,200,188858,340,372701,549,16,47,0,0,0
3/8/2013,BIHAR,,"Total 
                        :-",11249814,888088,59254,388166,5759377,527986,4574285,916152,10333662,6829,28165,1088,3750,55,367
3/8/2013,CHHATTISGARH,1,BASTAR(JAGDALPUR),224839,5872,127940,5134,126794,6615,86297,11749,213091,271,3471,212,1074,5,17
3/8/2013,CHHATTISGARH,2,BILASPUR,371399,869,8700,853,202904,1657,165985,2510,368889,0,2524,0,1194,0,0
3/8/2013,CHHATTISGARH,3,DANTEWADA,115788,336,13764,6838,73526,4965,30459,11803,103985,405,1475,176,1020,2,0
3/8/2013,CHHATTISGARH,4,DHAMTARI,122676,8569,38390,6119,38313,5488,72756,11607,111069,256,1627,50,321,1,0
3/8/2013,CHHATTISGARH,5,DURG,348076,14531,26337,14167,101901,14318,217690,28485,319591,1209,1466,289,291,5,0
3/8/2013,CHHATTISGARH,6,JANJGIR - CHAMPA,221272,51126,26344,7603,106569,24127,82973,31730,189542,120,2908,737,52,2,0
3/8/2013,CHHATTISGARH,7,JASHPUR,141873,3190,48424,6427,56062,7745,71639,14172,127701,890,1401,106,289,0,4
3/8/2013,CHHATTISGARH,8,KANKER,115378,5424,66214,2078,50835,1900,60565,3978,111400,33,1737,220,344,0,50
3/8/2013,CHHATTISGARH,9,KAWARDHA(KABIRDHAM),101715,0,0,2169,52932,6381,40233,8550,93165,1,1344,6,141,0,0
3/8/2013,CHHATTISGARH,10,KORBA,138150,0,0,0,71191,566,66393,566,137584,2,2081,2,888,0,0
3/8/2013,CHHATTISGARH,11,KORIYA,77822,4570,32898,1240,38251,1235,37096,2475,75347,27,2264,74,947,0,13
3/8/2013,CHHATTISGARH,12,MAHASAMUND,172481,25894,55892,1310,97835,2723,70613,4033,168448,229,1261,7,140,0,4
3/8/2013,CHHATTISGARH,13,RAIGARH,209401,27338,61624,2019,128378,4798,74206,6817,202584,50,2006,25,904,4,8
3/8/2013,CHHATTISGARH,14,RAIPUR,456778,80291,72576,58748,159859,59606,178565,118354,338424,2681,1609,503,185,1,0
3/8/2013,CHHATTISGARH,15,RAJNANDGAON,205040,17936,66632,6332,76544,10539,111625,16871,188169,238,1989,144,622,0,0
3/8/2013,CHHATTISGARH,16,SURGUJA,385384,0,0,42292,168828,2788,171476,45080,340304,17,3047,4,466,0,5
3/8/2013,CHHATTISGARH,,"Total 
                        :-",3408072,245946,645735,163329,1550722,155451,1538571,318780,3089293,6429,32210,2555,8878,20,101
3/8/2013,D & N HAVELI,1,DADRA AND NAGAR HAVELI,0,0,0,0,0,0,0,0,0,0,0,0,0,0,0
3/8/2013,D & N HAVELI,,"Total 
                        :-",0,0,0,0,0,0,0,0,0,0,0,0,0,0,0
3/8/2013,GOA,1,NORTH GOA,59768,2157,468,307,3698,55763,0,56070,3698,415,99,166,0,0,0
3/8/2013,GOA,2,SOUTH GOA,65260,251,1039,1210,1725,35611,26714,36821,28439,180,134,49,272,0,0
3/8/2013,GOA,,"Total 
                        :-",125028,2408,1507,1517,5423,91374,26714,92891,32137,595,233,215,272,0,0
3/8/2013,GUJARAT,1,AHMEDABAD,271385,34538,5678,29212,75235,83402,83536,112614,158771,70,902,82,314,1,46
3/8/2013,GUJARAT,2,AMRELI,193340,20939,1,22598,63014,50822,56906,73420,119920,768,678,487,732,3,52
3/8/2013,GUJARAT,3,ANAND,286920,28515,8360,35404,82760,94516,74240,129920,157000,390,515,879,243,23,52
3/8/2013,GUJARAT,4,BANAS KANTHA,433962,4593,2155,36155,125376,50033,222398,86188,347774,22,2038,20,1279,8,62
3/8/2013,GUJARAT,5,BHARUCH,231499,12625,78324,31623,58601,75231,66044,106854,124645,23,789,15,882,7,65
3/8/2013,GUJARAT,6,BHAVNAGAR,101327,5562,36,635,31244,10590,58858,11225,90102,140,796,97,998,25,39
3/8/2013,GUJARAT,7,DAHOD,160043,7929,150694,0,124000,2043,34000,2043,158000,387,1172,3,1897,0,87
3/8/2013,GUJARAT,8,DANGS,39343,185,39068,187,27900,453,10803,640,38703,383,85,134,288,33,40
3/8/2013,GUJARAT,9,GANDHINAGAR,97006,4379,964,3,13737,62268,20998,62271,34735,41,598,13,630,13,41
3/8/2013,GUJARAT,10,JAMNAGAR,222755,14676,239,11184,66456,44404,100711,55588,167167,898,784,546,650,31,67
3/8/2013,GUJARAT,11,JUNAGADH,310966,22768,2331,46585,90437,43451,130493,90036,220930,159,982,11,508,0,50
3/8/2013,GUJARAT,12,KACHCHH,248674,5586,216,4770,43013,63853,137038,68623,180051,85,945,73,314,0,84
3/8/2013,GUJARAT,13,KHEDA,326254,23113,7913,61541,104317,65025,95371,126566,199688,437,1204,174,1631,23,82
3/8/2013,GUJARAT,14,MAHESANA,320193,5949,0,7508,57207,63870,191608,71378,248815,666,268,726,1315,5,57
3/8/2013,GUJARAT,15,NARMADA,104115,2251,69813,1377,58730,26623,17385,28000,76115,261,416,11,520,0,65
3/8/2013,GUJARAT,16,NAVSARI,209227,3006,112157,10622,73486,35008,90111,45630,163597,474,592,99,1118,15,79
3/8/2013,GUJARAT,17,PANCH MAHALS,322283,15735,92114,20976,159912,102176,39219,123152,199131,393,2044,301,1047,19,61
3/8/2013,GUJARAT,18,PATAN,208376,15087,1357,4771,92051,16786,94768,21557,186819,418,795,202,780,0,58
3/8/2013,GUJARAT,19,PORBANDAR,67699,5548,376,5408,17024,10514,34753,15922,51777,142,306,117,110,12,64
3/8/2013,GUJARAT,20,RAJKOT,327946,15161,9330,21959,130374,51870,123743,73829,254117,653,1712,311,633,24,71
3/8/2013,GUJARAT,21,SABAR KANTHA,444887,27070,62558,4320,151382,29538,259647,33858,411029,36,3611,28,1304,0,63
3/8/2013,GUJARAT,22,SURAT,406006,8630,266090,51894,160397,86506,107209,138400,267606,691,1096,562,1537,0,51
3/8/2013,GUJARAT,23,SURENDRANAGAR,165976,19442,3454,1520,55834,7142,101480,8662,157314,405,781,16,1298,3,55
3/8/2013,GUJARAT,24,VADODARA,440874,15444,86876,56694,140958,115395,127827,172089,268785,83,1104,50,1956,11,44
3/8/2013,GUJARAT,25,VALSAD,237452,11159,164412,42822,79836,74053,40741,116875,120577,286,755,327,934,3,98
3/8/2013,GUJARAT,,"Total 
                        :-",6178508,329890,1164516,509768,2083281,1265572,2319887,1775340,4403168,8311,24968,5284,22918,259,1533
3/8/2013,HARYANA,1,AMBALA,101594,32008,0,1670,31718,19342,48864,21012,80582,9,576,7,590,3,65
3/8/2013,HARYANA,2,BHIWANI,202740,40163,0,14633,47488,70292,70327,84925,117815,59,339,302,439,0,29
3/8/2013,HARYANA,3,FARIDABAD,131580,30247,0,2516,15833,30366,82865,32882,98698,348,259,80,627,15,0
3/8/2013,HARYANA,4,FATEHABAD,131813,32600,0,1953,25642,47766,56452,49719,82094,743,429,99,171,0,23
3/8/2013,HARYANA,5,GURGAON,92830,20491,0,3277,10502,27865,51186,31142,61688,225,132,127,344,56,1
3/8/2013,HARYANA,6,HISAR,206968,49473,0,2681,46065,56710,101512,59391,147577,45,796,37,391,1,54
3/8/2013,HARYANA,7,JHAJJAR,123578,22748,0,2127,22014,26706,72731,28833,94745,274,153,52,447,1,45
3/8/2013,HARYANA,8,JIND,186332,42629,0,6546,53509,18113,108164,24659,161673,439,3,449,393,0,0
3/8/2013,HARYANA,9,KAITHAL,117878,23367,57,5084,36861,29847,46086,34931,82947,446,126,100,3,17,71
3/8/2013,HARYANA,10,KARNAL,158132,37877,0,17968,39445,56624,44095,74592,83540,164,506,362,303,5,76
3/8/2013,HARYANA,11,KURUKSHETRA,98970,27420,0,5637,22292,24508,46533,30145,68825,162,214,129,241,0,49
3/8/2013,HARYANA,12,MAHENDRAGARH,114891,19575,0,213,17500,17178,80000,17391,97500,308,253,169,554,6,81
3/8/2013,HARYANA,13,MEWAT,147377,14407,0,10918,21935,15551,98973,26469,120908,196,376,46,175,9,33
3/8/2013,HARYANA,14,PANCHKULA,35272,3589,0,951,8702,6839,18780,7790,27482,108,112,6,68,2,16
3/8/2013,HARYANA,15,PANIPAT,118364,20217,0,3438,25887,50490,38549,53928,64436,117,87,315,207,14,2
3/8/2013,HARYANA,16,REWARI,112943,21038,0,1267,27943,19577,64156,20844,92099,57,620,230,0,20,40
3/8/2013,HARYANA,17,ROHTAK,102117,23018,0,74,22140,221,79682,295,101822,24,129,0,17,0,60
3/8/2013,HARYANA,18,SIRSA,148306,33666,0,12050,24631,84104,27521,96154,52152,355,44,94,246,2,0
3/8/2013,HARYANA,19,SONIPAT,189263,38741,0,13134,29808,79048,67273,92182,97081,55,100,266,368,0,50
3/8/2013,HARYANA,20,YAMUNANAGAR,126071,37170,0,2465,28933,47484,47189,49949,76122,68,437,80,356,1,47
3/8/2013,HARYANA,,"Total 
                        :-",2647019,570444,57,108602,558848,728631,1250938,837233,1809786,4202,5691,2950,5940,152,742
3/8/2013,HIMACHAL PRADESH,1,BILASPUR,73809,18421,3177,5560,11931,17663,38655,23223,50586,475,312,174,286,0,13
3/8/2013,HIMACHAL PRADESH,2,CHAMBA,87351,17944,24750,3138,44027,8540,31646,11678,75673,563,1023,0,105,0,41
3/8/2013,HIMACHAL PRADESH,3,HAMIRPUR,97488,15957,306,8410,11498,33864,43716,42274,55214,467,317,453,502,0,10
3/8/2013,HIMACHAL PRADESH,4,KANGRA,290691,57721,14576,20214,44901,76417,149159,96631,194060,1328,1083,145,1045,19,0
3/8/2013,HIMACHAL PRADESH,5,KINNAUR,17763,5898,11865,1336,1558,2362,12507,3698,14065,92,175,3,33,0,0
3/8/2013,HIMACHAL PRADESH,6,KULLU,66081,19269,1813,1472,9573,13214,41822,14686,51395,593,303,53,321,4,49
3/8/2013,HIMACHAL PRADESH,7,LAHAUL & SPITI,5440,550,4890,1731,680,2498,531,4229,1211,139,123,2,108,0,0
3/8/2013,HIMACHAL PRADESH,8,MANDI,205356,56371,5371,6924,34407,46228,117797,53152,152204,633,1441,586,60,1,57
3/8/2013,HIMACHAL PRADESH,9,SHIMLA,109998,32753,497,7753,23874,25307,53064,33060,76938,351,1871,24,901,0,0
3/8/2013,HIMACHAL PRADESH,10,SIRMAUR,71024,9227,1187,1611,12001,12436,44976,14047,56977,330,825,0,133,0,33
3/8/2013,HIMACHAL PRADESH,11,SOLAN,70147,23679,2484,7002,10858,22938,29349,29940,40207,635,426,200,236,11,42
3/8/2013,HIMACHAL PRADESH,12,UNA,90838,21728,1233,7105,8320,33344,42069,40449,50389,537,150,100,385,0,11
3/8/2013,HIMACHAL PRADESH,,"Total 
                        :-",1185986,279518,72149,72256,213628,294811,605291,367067,818919,6143,8049,1740,4115,35,256
3/8/2013,JAMMU & KASHMIR,1,ANANTNAG,52249,0,2338,11120,21736,5316,14077,16436,35813,56,53,7,3,4,0
3/8/2013,JAMMU & KASHMIR,2,BANDIPORA,2859,0,0,915,1200,355,389,1270,1589,0,0,0,0,0,0
3/8/2013,JAMMU & KASHMIR,3,BARAMULLA,3863,0,255,488,2030,869,476,1357,2506,15,28,0,19,0,0
3/8/2013,JAMMU & KASHMIR,4,BUDGAM,72371,0,2406,10497,29943,14063,17868,24560,47811,358,200,16,37,28,22
3/8/2013,JAMMU & KASHMIR,5,DODA,59551,8357,5022,8825,32163,8410,10153,17235,42316,450,523,1,17,27,0
3/8/2013,JAMMU & KASHMIR,6,JAMMU,177725,73047,10596,6638,33397,49494,88196,56132,121593,905,295,17,27,86,44
3/8/2013,JAMMU & KASHMIR,7,KARGIL,0,0,0,0,0,0,0,0,0,0,0,0,0,0,0
3/8/2013,JAMMU & KASHMIR,8,KATHUA,81919,18621,6145,2430,18711,10646,50132,13076,68843,749,319,12,33,9,0
3/8/2013,JAMMU & KASHMIR,9,KISHTWAR,22350,2577,5601,6323,16027,0,0,6323,16027,163,462,181,0,2,0
3/8/2013,JAMMU & KASHMIR,10,KULGAM,61270,1036,5192,9728,25581,8996,16965,18724,42546,158,385,60,275,15,45
3/8/2013,JAMMU & KASHMIR,11,KUPWARA,0,0,0,0,0,0,0,0,0,0,0,0,0,0,0
3/8/2013,JAMMU & KASHMIR,12,LEH (LADAKH),10290,0,10290,2210,2268,5812,0,8022,2268,110,75,53,42,54,36
3/8/2013,JAMMU & KASHMIR,13,POONCH,65880,14,26058,11153,28640,8053,18034,19206,46674,526,356,1,48,5,0
3/8/2013,JAMMU & KASHMIR,14,PULWAMA,48334,0,0,0,23492,15268,9574,15268,33066,0,617,0,16,3,47
3/8/2013,JAMMU & KASHMIR,15,RAJAURI,90021,5972,34009,5094,36427,7347,41153,12441,77580,552,801,2,5,9,1
3/8/2013,JAMMU & KASHMIR,16,RAMBAN,34334,31,2150,8408,14359,5515,6052,13923,20411,350,294,0,23,1,0
3/8/2013,JAMMU & KASHMIR,17,REASI,48328,7440,15540,2997,20203,25128,0,28125,20203,268,222,92,45,25,4
3/8/2013,JAMMU & KASHMIR,18,SAMBA,45637,13212,3150,1315,7959,36363,0,37678,7959,328,51,25,20,13,0
3/8/2013,JAMMU & KASHMIR,19,SHOPIAN,10196,0,112,0,10196,0,0,0,10196,0,300,0,8,0,10
3/8/2013,JAMMU & KASHMIR,20,SRINAGAR,3160,0,360,859,719,1273,309,2132,1028,11,4,15,26,13,0
3/8/2013,JAMMU & KASHMIR,21,UDHAMPUR,67838,16358,7282,7416,23593,8796,28033,16212,51626,794,530,12,18,10,25
3/8/2013,JAMMU & KASHMIR,,"Total 
                        :-",958175,146665,136506,96416,348644,211704,301411,308120,650055,5793,5515,494,662,304,234
3/8/2013,JHARKHAND,1,BOKARO,116246,1190,1796,0,103125,2342,10779,2342,113904,0,1364,0,102,3,6
3/8/2013,JHARKHAND,2,CHATRA,138135,34118,5215,12743,98213,2407,24772,15150,122985,74,909,67,476,0,19
3/8/2013,JHARKHAND,3,DEOGHAR,156684,0,0,0,72783,0,83901,0,156684,296,0,0,225,0,1
3/8/2013,JHARKHAND,4,DHANBAD,194074,33001,33950,0,104672,737,88665,737,193337,5,2125,5,44,0,0
3/8/2013,JHARKHAND,5,DUMKA,185659,1,0,65,148732,552,36310,617,185042,179,2776,4,115,0,0
3/8/2013,JHARKHAND,6,GARHWA,127828,110,0,3321,73442,4518,46547,7839,119989,0,469,0,713,0,0
3/8/2013,JHARKHAND,7,GIRIDIH,209494,726,1509,3112,155016,7306,44060,10418,199076,21,68,19,741,0,27
3/8/2013,JHARKHAND,8,GODDA,200289,20873,55650,0,95732,0,104557,0,200289,26,1612,16,73,0,0
3/8/2013,JHARKHAND,9,GUMLA,197017,15534,130732,5294,89998,4651,97074,9945,187072,229,807,112,307,0,0
3/8/2013,JHARKHAND,10,HAZARIBAGH,212453,38658,15162,14199,127150,5937,65167,20136,192317,617,951,89,162,1,0
3/8/2013,JHARKHAND,11,JAMTARA,94923,0,0,0,67240,168,27515,168,94755,52,214,39,214,1,0
3/8/2013,JHARKHAND,12,KHUNTI,74086,25162,36118,11277,44931,6575,11303,17852,56234,16,8,9,2,0,0
3/8/2013,JHARKHAND,13,KODERMA,43808,8974,5971,204,39939,284,3381,488,43320,7,452,3,343,0,0
3/8/2013,JHARKHAND,14,LATEHAR,101730,28808,42641,2393,79635,5150,14552,7543,94187,5,1725,7,303,0,0
3/8/2013,JHARKHAND,15,LOHARDAGA,47855,2073,35728,0,22626,0,25229,0,47855,0,313,0,307,0,7
3/8/2013,JHARKHAND,16,PAKUR,101317,6193,45239,114,72250,556,28397,670,100647,0,800,0,531,0,0
3/8/2013,JHARKHAND,17,PALAMU,246764,78009,19719,7364,91145,10178,138077,17542,229222,51,470,32,80,0,6
3/8/2013,JHARKHAND,18,PASCHIM SINGHBHUM,206313,8736,144604,842,170083,1949,33439,2791,203522,322,3063,156,361,0,7
3/8/2013,JHARKHAND,19,PURBI SINGHBHUM,167469,16256,28337,4033,96510,2353,64573,6386,161083,33,320,17,126,0,0
3/8/2013,JHARKHAND,20,RAMGARH,62188,8609,19090,10,48949,6,13223,16,62172,92,262,30,39,0,1
3/8/2013,JHARKHAND,21,RANCHI,266921,69480,106133,29732,179077,18702,39410,48434,218487,148,673,306,699,7,7
3/8/2013,JHARKHAND,22,SAHIBGANJ,126623,8045,39815,630,112674,835,12484,1465,125158,150,615,24,800,0,0
3/8/2013,JHARKHAND,23,SERAIKELA KHARSAWAN,163994,8990,84309,0,103882,683,59429,683,163311,86,877,30,357,2,0
3/8/2013,JHARKHAND,24,SIMDEGA,89016,8815,59919,4299,54556,2187,27974,6486,82530,109,66,26,160,0,0
3/8/2013,JHARKHAND,,"Total 
                        :-",3530886,422361,911637,99632,2252360,78076,1100818,177708,3353178,2518,20939,991,7280,14,81
3/8/2013,KARNATAKA,1,BAGALKOT,223315,38193,8893,0,74926,0,148389,0,223315,36,745,0,1016,0,0
3/8/2013,KARNATAKA,2,BANGALORE RURAL,140884,35298,9393,15711,63044,23386,38743,39097,101787,526,1246,284,414,0,4
3/8/2013,KARNATAKA,3,BANGALORE URBAN,194239,44147,4346,37600,49690,79651,27298,117251,76988,722,85,336,413,1,42
3/8/2013,KARNATAKA,4,BELGAUM,718036,78562,39491,47168,186678,55223,428967,102391,615645,776,1994,27,1618,3,25
3/8/2013,KARNATAKA,5,BELLARY,252818,53709,54466,36203,100252,30509,85854,66712,186106,400,852,414,582,5,93
3/8/2013,KARNATAKA,6,BIDAR,234074,51715,39119,56210,58384,45286,74194,101496,132578,1012,108,833,101,6,0
3/8/2013,KARNATAKA,7,BIJAPUR,235808,6043,1270,4776,122381,16310,92341,21086,214722,964,1032,506,599,6,0
3/8/2013,KARNATAKA,8,CHAMARAJANAGAR,173032,42444,16432,27547,110188,6500,28797,34047,138985,615,263,1,871,0,0
3/8/2013,KARNATAKA,9,CHICKMAGALUR,179144,38366,8137,18941,35757,43818,80628,62759,116385,641,926,480,739,0,0
3/8/2013,KARNATAKA,10,CHITRADURGA,257955,72463,60539,9429,74948,56105,117473,65534,192421,733,659,65,1016,5,5
3/8/2013,KARNATAKA,11,DAVANGERE,264812,61020,34921,8182,83670,18137,154823,26319,238493,541,905,5,971,0,0
3/8/2013,KARNATAKA,12,DHARWAD,136286,13842,11540,11879,53596,10544,60267,22423,113863,554,615,0,586,0,17
3/8/2013,KARNATAKA,13,GADAG,107855,23459,11880,8510,46821,13004,39520,21514,86341,352,291,7,431,21,27
3/8/2013,KARNATAKA,14,GULBARGA,440884,7243,7276,19,268019,850,171996,869,440015,431,4024,13,2232,0,50
3/8/2013,KARNATAKA,15,HASSAN,333834,58121,13226,37119,64134,16298,216283,53417,280417,602,1902,683,1173,0,15
3/8/2013,KARNATAKA,16,HAVERI,193163,28096,17548,6019,98278,30991,57875,37010,156153,349,818,162,785,0,46
3/8/2013,KARNATAKA,17,KODAGU,105683,11539,9359,4062,38838,44688,18095,48750,56933,284,179,284,287,0,50
3/8/2013,KARNATAKA,18,KOLAR,381339,96049,46337,14229,107858,84568,174684,98797,282542,2723,1715,173,2162,0,0
3/8/2013,KARNATAKA,19,KOPPAL,213700,19011,13887,0,60868,291,152541,291,213409,111,609,26,610,0,50
3/8/2013,KARNATAKA,20,MANDYA,313960,48292,4881,8995,112126,44946,147893,53941,260019,1043,1602,51,703,1,26
3/8/2013,KARNATAKA,21,MANGALORE(DAKSHINA KANNADA),255913,20065,12210,49583,59478,111320,35532,160903,95010,376,1236,1045,505,8,70
3/8/2013,KARNATAKA,22,MYSORE,304720,65834,38229,45909,76614,65726,116471,111635,193085,142,305,128,245,0,0
3/8/2013,KARNATAKA,23,RAICHUR,234772,41296,39052,10033,94934,9279,120526,19312,215460,1231,356,396,230,10,0
3/8/2013,KARNATAKA,24,RAMANAGARA,169409,23856,4578,17613,41876,51113,58807,68726,100683,591,1360,273,501,0,9
3/8/2013,KARNATAKA,25,SHIMOGA,219588,42443,12988,45324,98863,35716,39685,81040,138548,983,951,568,960,0,0
3/8/2013,KARNATAKA,26,TUMKUR,468476,90573,38239,42139,242872,47220,136245,89359,379117,1939,1641,133,1845,8,50
3/8/2013,KARNATAKA,27,UDUPI,182454,10658,8526,44122,42889,61425,34018,105547,76907,350,345,595,384,0,0
3/8/2013,KARNATAKA,28,UTTAR KANNADA,209255,15780,5062,29952,106046,13473,59784,43425,165830,7,2155,11,1267,0,50
3/8/2013,KARNATAKA,,"Total 
                        :-",7145408,1138117,571825,637274,2574028,1016377,2917729,1653651,5491757,19034,28919,7499,23246,74,629
3/8/2013,KERALA,1,ALAPPUZHA,344155,32737,599,120576,114359,107031,2189,227607,116548,233,138,442,206,0,3
3/8/2013,KERALA,2,ERNAKULAM,479197,192685,4294,144084,54585,264469,16059,408553,70644,232,53,1592,145,0,4
3/8/2013,KERALA,3,IDUKKI,222833,33982,9715,71255,83635,56163,11780,127418,95415,76,100,805,185,0,42
3/8/2013,KERALA,4,KANNUR,316095,20464,3512,121231,34121,160743,0,281974,34121,522,168,1332,350,0,0
3/8/2013,KERALA,5,KASARGOD,165946,4313,2459,21355,56427,64864,23300,86219,79727,262,279,740,382,0,10
3/8/2013,KERALA,6,KOLLAM,355344,55573,989,69295,94679,184242,7128,253537,101807,78,362,755,343,0,33
3/8/2013,KERALA,7,KOTTAYAM,403920,32186,4190,137986,28118,236160,1656,374146,29774,179,182,536,133,0,40
3/8/2013,KERALA,8,KOZHIKODE,431115,32341,2231,139157,42285,247587,2086,386744,44371,186,127,1561,247,0,15
3/8/2013,KERALA,9,MALAPPURAM,585037,51792,3846,232949,36422,311670,3996,544619,40418,182,358,0,0,0,0
3/8/2013,KERALA,10,PALAKKAD,491803,82857,12777,146950,107013,213416,24424,360366,131437,175,162,1031,455,1,5
3/8/2013,KERALA,11,PATHANAMTHITTA,259403,26147,1879,62018,53184,143001,1200,205019,54384,96,172,205,121,14,11
3/8/2013,KERALA,12,THIRUVANANTHAPURAM,550455,67514,5011,111663,126813,302527,9452,414190,136265,28,344,844,496,0,13
3/8/2013,KERALA,13,THRISSUR,449906,41546,1525,187442,48669,207927,5868,395369,54537,731,316,1132,839,0,22
3/8/2013,KERALA,14,WAYANAD,155734,9549,31717,64013,38538,51083,2100,115096,40638,99,57,0,0,0,0
3/8/2013,KERALA,,"Total 
                        :-",5210943,683686,84744,1629974,918848,2550883,111238,4180857,1030086,3079,2818,10975,3902,15,198
3/8/2013,MADHYA PRADESH,1,ALIRAJPUR,66504,783,61692,2870,34778,1202,27654,4072,62432,192,602,65,63,0,2
3/8/2013,MADHYA PRADESH,2,ANUPPUR,122364,11708,76685,11605,38903,10359,61497,21964,100400,429,993,147,408,19,8
3/8/2013,MADHYA PRADESH,3,ASHOKNAGAR,119894,28024,13907,970,54450,2415,62059,3385,116509,0,853,0,37,0,0
3/8/2013,MADHYA PRADESH,4,BALAGHAT,307680,27994,57596,14426,171243,16654,105357,31080,276600,1118,733,422,433,12,19
3/8/2013,MADHYA PRADESH,5,BARWANI,142005,0,0,11870,63684,10303,56148,22173,119832,257,1039,261,350,6,41
3/8/2013,MADHYA PRADESH,6,BETUL,189215,6,20,7556,43745,13144,124770,20700,168515,2,1285,0,30,0,0
3/8/2013,MADHYA PRADESH,7,BHIND,75642,0,0,1650,42573,7083,24336,8733,66909,3,1221,0,66,0,3
3/8/2013,MADHYA PRADESH,8,BHOPAL,67572,18941,3336,5509,19528,6055,36480,11564,56008,189,461,2,155,0,0
3/8/2013,MADHYA PRADESH,9,BURHANPUR,83203,7279,27871,3385,34074,6117,39627,9502,73701,3,658,2,154,0,23
3/8/2013,MADHYA PRADESH,10,CHHATARPUR,240930,54190,12734,4101,72527,4247,160055,8348,232582,300,1859,4,232,0,9
3/8/2013,MADHYA PRADESH,11,CHHINDWARA,304759,59883,68838,10079,117268,16374,160513,26453,277781,203,4840,600,416,1,50
3/8/2013,MADHYA PRADESH,12,DAMOH,147239,1066,313,1583,92368,481,52807,2064,145175,34,1944,16,103,0,21
3/8/2013,MADHYA PRADESH,13,DATIA,56044,0,0,10315,11956,10658,23115,20973,35071,169,257,31,70,0,0
3/8/2013,MADHYA PRADESH,14,DEWAS,161039,0,0,9601,59094,15753,76591,25354,135685,6,887,1,23,1,34
3/8/2013,MADHYA PRADESH,15,DHAR,276411,7804,90258,22141,92776,39281,122213,61422,214989,357,2424,46,345,0,0
3/8/2013,MADHYA PRADESH,16,DINDORI,135663,10017,77435,192,63451,2623,69397,2815,132848,0,1166,0,283,0,6
3/8/2013,MADHYA PRADESH,17,GUNA,118029,0,0,7758,34798,30834,44639,38592,79437,1185,17,405,1,0,9
3/8/2013,MADHYA PRADESH,18,GWALIOR,127370,30222,12025,1146,32128,2589,91507,3735,123635,67,1894,70,140,1,30
3/8/2013,MADHYA PRADESH,19,HARDA,66900,847,550,3307,23589,5886,34118,9193,57707,27,730,17,51,0,4
3/8/2013,MADHYA PRADESH,20,HOSHANGABAD,157337,19328,20326,21976,50677,13493,71191,35469,121868,157,1429,39,609,1,6
3/8/2013,MADHYA PRADESH,21,INDORE,146842,29082,14728,4647,27895,11505,102795,16152,130690,115,648,81,416,0,0
3/8/2013,MADHYA PRADESH,22,JABALPUR,227432,20922,38969,9785,106289,32609,78749,42394,185038,997,1454,614,260,43,10
3/8/2013,MADHYA PRADESH,23,JHABUA,149999,1692,139035,5941,82620,4465,57453,10406,140073,56,1642,8,384,0,10
3/8/2013,MADHYA PRADESH,24,KATNI,157312,41681,27856,5078,53000,6798,92436,11876,145436,1,1710,20,918,4,15
3/8/2013,MADHYA PRADESH,25,KHANDWA(EAST NIMAR),166931,22044,52923,7220,66896,19380,73435,26600,140331,355,744,173,392,0,0
3/8/2013,MADHYA PRADESH,26,KHARGONE,251641,36175,79936,33367,70725,49322,98227,82689,168952,2483,408,531,149,0,6
3/8/2013,MADHYA PRADESH,27,MANDLA,181442,7098,100624,17508,98633,12867,52434,30375,151067,1114,1361,395,300,16,0
3/8/2013,MADHYA PRADESH,28,MANDSAUR,171682,22594,5908,9186,46666,12809,103021,21995,149687,350,1092,28,339,0,48
3/8/2013,MADHYA PRADESH,29,MORENA,208269,43731,4059,4078,32416,15111,156664,19189,189080,259,1706,82,142,1,50
3/8/2013,MADHYA PRADESH,30,NARSINGHPUR,182024,35935,27089,22576,65892,35590,57966,58166,123858,991,317,527,373,31,19
3/8/2013,MADHYA PRADESH,31,NEEMUCH,102282,13365,10911,3137,27831,6615,64699,9752,92530,111,1342,0,62,0,13
3/8/2013,MADHYA PRADESH,32,PANNA,145739,30364,23216,19499,63423,9767,53050,29266,116473,199,1145,43,12,0,2
3/8/2013,MADHYA PRADESH,33,RAISEN,154767,4844,2634,696,69701,1059,83311,1755,153012,57,2192,36,869,0,22
3/8/2013,MADHYA PRADESH,34,RAJGARH,208402,31896,6504,5473,93722,3696,105511,9169,199233,245,1378,3,147,8,0
3/8/2013,MADHYA PRADESH,35,RATLAM,147314,24459,52552,6650,54090,13040,73534,19690,127624,607,436,11,42,0,0
3/8/2013,MADHYA PRADESH,36,REWA,309098,17352,13263,5443,121538,7910,174207,13353,295745,0,4082,1,198,0,4
3/8/2013,MADHYA PRADESH,37,SAGAR,296553,69588,29721,34239,126571,21283,114460,55522,241031,1042,288,123,114,1,0
3/8/2013,MADHYA PRADESH,38,SATNA,336002,51849,50988,6099,158792,67196,103915,73295,262707,490,937,237,515,0,0
3/8/2013,MADHYA PRADESH,39,SEHORE,132984,159,168,11552,34210,18679,68543,30231,102753,608,646,110,78,0,3
3/8/2013,MADHYA PRADESH,40,SEONI,234407,71637,46171,10113,104243,13460,106591,23573,210834,748,2336,197,468,4,0
3/8/2013,MADHYA PRADESH,41,SHAHDOL,177216,13751,70625,5182,84718,10646,76670,15828,161388,646,836,91,752,4,0
3/8/2013,MADHYA PRADESH,42,SHAJAPUR,199410,16055,1457,2927,69825,5029,121631,7956,191456,279,1182,1,108,0,12
3/8/2013,MADHYA PRADESH,43,SHEOPUR,90469,13654,16936,211,18155,380,71723,591,89878,0,654,0,58,0,9
3/8/2013,MADHYA PRADESH,44,SHIVPURI,214022,72059,55972,3981,62283,8514,139244,12495,201527,99,2403,3,147,1,0
3/8/2013,MADHYA PRADESH,45,SIDHI,205883,30024,57050,9125,112006,5385,79367,14510,191373,721,1451,50,54,3,0
3/8/2013,MADHYA PRADESH,46,SINGRAULI,128690,18264,41270,12473,24915,2317,49067,14790,73982,721,421,69,40,3,0
3/8/2013,MADHYA PRADESH,47,TIKAMGARH,171959,57584,10331,6255,66822,1437,97445,7692,164267,38,1191,0,108,0,0
3/8/2013,MADHYA PRADESH,48,UJJAIN,183195,56526,5033,831,67737,10004,104623,10835,172360,43,988,25,298,4,10
3/8/2013,MADHYA PRADESH,49,UMARIA,111469,6658,55814,7,51236,4112,56003,4119,107239,67,1418,23,449,0,22
3/8/2013,MADHYA PRADESH,50,VIDISHA,192212,0,0,3233,95981,3014,89984,6247,185965,77,1901,0,145,0,12
3/8/2013,MADHYA PRADESH,,"Total 
                        :-",8551447,1139134,1565329,418552,3312441,629550,4150832,1048102,7463273,18217,63601,5610,12306,164,532
