State_Name,District_Name,Project_Objectives_IHHL_BPL,Project_Objectives_IHHL_APL,Project_Objectives_IHHL_TOTAL,Project_Objectives_SCW,Project_Objectives_School_Toilets,Project_Objectives_Anganwadi_Toilets,Project_Objectives_RSM,Project_Objectives_PC,Project_Performance-IHHL_BPL,Project_Performance-IHHL_APL,Project_Performance-IHHL_TOTAL,Project_Performance-SCW,Project_Performance-School_Toilets,Project_Performance-Anganwadi_Toilets,Project_Performance-RSM,Project_Performance-PC
ANDHRA PRADHESH,ADILABAD,247475,148181,395656,0,4462,427,10,0,176642,52431,229073,0,5030,427,0,0
ANDHRA PRADHESH,ANANTAPUR,363314,181335,544649,0,3421,284,10,0,366557,42000,408557,0,4258,302,0,0
ANDHRA PRADHESH,CHITTOOR,296465,236986,533451,0,8171,375,10,0,271890,193590,465480,0,8171,375,11,0
ANDHRA PRADHESH,CUDDAPAH,251653,251610,503263,0,6802,277,10,0,241228,125493,366721,0,5431,277,0,0
ANDHRA PRADHESH,EAST GODAVARI,370255,191400,561655,50,7004,1164,10,0,349876,191400,541276,49,7004,781,20,0
ANDHRA PRADHESH,GUNTUR,370996,319053,690049,0,5346,215,10,0,270343,85950,356293,0,5116,215,37,0
ANDHRA PRADHESH,KARIMNAGAR,365267,219763,585030,0,5848,298,10,0,381686,63025,444711,0,6148,425,13,0
ANDHRA PRADHESH,KHAMMAM,189225,4860,194085,0,6318,521,10,0,200555,4870,205425,0,6318,521,15,10
ANDHRA PRADHESH,KRISHNA,351572,175991,527563,17,3374,62,10,0,320082,104197,424279,8,3374,171,40,0
ANDHRA PRADHESH,KURNOOL,383478,129956,513434,0,4669,2111,10,0,324295,174773,499068,13,4669,252,49,0
ANDHRA PRADHESH,MAHBUBNAGAR,418559,66032,484591,3,5433,357,10,0,244104,263280,507384,9,5434,357,15,0
ANDHRA PRADHESH,MEDAK,311743,96490,408233,50,5446,1873,10,0,311591,47977,359568,16,4752,1049,10,0
ANDHRA PRADHESH,NALGONDA,215058,156761,371819,0,6628,44,10,0,235390,87693,323083,0,6527,788,10,10
ANDHRA PRADHESH,NELLORE,226725,116678,343403,0,6415,1396,10,0,170494,19462,189956,0,5839,476,0,0
ANDHRA PRADHESH,NIZAMABAD,225519,9474,234993,0,2477,32,10,0,225519,64759,290278,0,2477,32,36,0
ANDHRA PRADHESH,PRAKASAM,386617,193493,580110,0,7224,780,10,0,307890,143248,451138,0,7234,770,41,0
ANDHRA PRADHESH,RANGAREDDI,212629,71610,284239,0,3726,467,10,0,177088,69147,246235,0,3726,467,10,0
ANDHRA PRADHESH,SRIKAKULAM,302221,225272,527493,40,6398,266,10,0,123242,82270,205512,16,5580,128,15,3
ANDHRA PRADHESH,VISAKHAPATNAM,252875,156460,409335,20,5074,0,10,0,178793,75765,254558,20,6378,560,0,0
ANDHRA PRADHESH,VIZIANAGARAM,220051,245678,465729,10,2999,1668,10,0,166750,159984,326734,8,3368,350,12,0
ANDHRA PRADHESH,WARANGAL,330260,138180,468440,0,4122,2157,10,0,359732,345450,705182,0,4122,481,0,0
ANDHRA PRADHESH,WEST GODAVARI,344272,294425,638697,385,4551,216,10,0,319797,294425,614222,837,4626,316,97,0
ARUNACHAL PRADHESH,ANJAW,3232,0,3232,8,44,46,1,0,1490,0,1490,2,48,48,0,0
ARUNACHAL PRADHESH,CHANGLANG,15716,2799,18515,25,384,250,0,0,7295,2450,9745,24,384,228,1,0
ARUNACHAL PRADHESH,DIBANG VALLEY,1085,0,1085,0,102,27,0,0,1088,0,1088,0,40,10,0,0
ARUNACHAL PRADHESH,EAST KAMENG,7016,1280,8296,25,288,216,0,0,5576,1280,6856,2,288,216,0,0
ARUNACHAL PRADHESH,EAST SIANG,8222,4723,12945,25,244,42,6,0,4537,1718,6255,4,244,50,0,0
ARUNACHAL PRADHESH,KURUNG KUMEY,22036,0,22036,30,684,164,0,0,11671,0,11671,3,684,164,0,0
ARUNACHAL PRADHESH,LOHIT,8800,0,8800,26,240,182,0,0,8410,1129,9539,23,240,182,1,0
ARUNACHAL PRADHESH,LOWER DIBANG VALLEY,2366,1200,3566,0,134,82,0,0,1513,1200,2713,0,134,82,0,0
ARUNACHAL PRADHESH,LOWER SUBANSIRI,5766,1164,6930,26,232,119,3,0,4516,1164,5680,19,232,119,3,0
ARUNACHAL PRADHESH,PAPUM PARE,1268,3778,5046,17,140,113,8,0,267,3778,4045,3,140,113,0,0
ARUNACHAL PRADHESH,TAWANG,5478,1210,6688,21,156,91,4,0,4191,1210,5401,13,156,75,1,0
ARUNACHAL PRADHESH,TIRAP,5780,470,6250,25,304,150,6,0,5780,470,6250,18,304,150,0,0
ARUNACHAL PRADHESH,UPPER SIANG,2634,964,3598,15,154,50,4,0,2326,964,3290,14,154,50,0,0
ARUNACHAL PRADHESH,UPPER SUBANSIRI,9045,461,9506,25,154,221,3,0,5872,461,6333,5,156,178,0,0
ARUNACHAL PRADHESH,WEST KAMENG,5644,252,5896,25,306,111,4,0,3744,252,3996,22,306,111,0,0
ARUNACHAL PRADHESH,WEST SIANG,11472,0,11472,25,378,2,0,0,6862,0,6862,5,378,20,0,0
ASSAM,BAGSHA,85697,63785,149482,15,1789,69,3,0,73500,21780,95280,15,1789,69,3,0
ASSAM,BARPETA,150747,93069,243816,0,1806,175,10,0,103579,33545,137124,0,2038,175,0,0
ASSAM,BONGAIGAON,51929,39654,91583,15,1222,59,3,0,5245,8881,14126,0,1252,59,0,0
ASSAM,CACHAR,119931,46293,166224,0,1839,1697,0,0,101328,20693,122021,1,1873,985,2,92
ASSAM,CHIRANG,29956,20899,50855,10,778,38,2,0,15666,2674,18340,3,778,38,2,0
ASSAM,DARRANG,86628,25633,112261,25,673,539,5,0,46085,6448,52533,0,673,243,0,0
ASSAM,DHEMAJI,80854,18546,99400,10,871,230,5,0,58498,15565,74063,10,887,230,5,4
ASSAM,DHUBRI,205324,42052,247376,50,1016,1902,2,0,120855,8790,129645,0,1181,576,4,9
ASSAM,DIBRUGARH,77606,45384,122990,0,969,900,4,0,69914,37030,106944,0,972,559,4,0
ASSAM,GOALPARA,65070,21747,86817,0,1840,951,3,0,55861,11252,67113,1,1840,804,3,4
ASSAM,GOLAGHAT,79743,27031,106774,0,1248,119,6,0,77985,22801,100786,0,1249,122,6,0
ASSAM,HAILAKANDI,49837,12445,62282,0,1140,35,4,0,49837,10570,60407,0,1140,35,4,0
ASSAM,JORHAT,65070,21747,86817,0,1840,951,6,0,53603,21747,75350,0,1852,701,3,1
ASSAM,KAMRUP,85785,52723,138508,0,521,1531,0,0,84725,21386,106111,0,521,975,0,0
ASSAM,KARBI ANGLONG,60953,19293,80246,0,3304,1406,4,0,9678,407,10085,0,2310,216,0,0
ASSAM,KARIMGANJ,78992,15409,94401,14,1051,912,3,0,76200,15409,91609,0,1054,623,1,0
ASSAM,KOKRAJHAR,84830,35087,119917,0,1157,146,3,0,76164,19928,96092,0,1226,146,2,1
ASSAM,LAKHIMPUR,73224,22938,96162,0,1432,276,4,0,60821,3900,64721,0,1432,276,7,3
ASSAM,MARIGAON,60770,105564,166334,0,326,797,3,0,56490,105564,162054,0,505,596,2,0
ASSAM,NAGAON,168391,60850,229241,0,2468,621,10,0,159819,12336,172155,0,2468,621,0,0
ASSAM,NALBARI,88093,127387,215480,0,282,710,5,0,54063,20039,74102,0,282,597,0,0
ASSAM,NORTH CACHAR HILLS,21328,1102,22430,0,810,194,5,0,5398,0,5398,0,54,16,0,0
ASSAM,SIBSAGAR,74686,52367,127053,0,2135,935,4,0,64135,22642,86777,0,2135,935,1,8
ASSAM,SONITPUR,120048,93032,213080,42,1951,607,6,0,102465,24927,127392,3,1951,607,3,0
ASSAM,TINSUKIA,68774,29814,98588,0,870,623,8,0,59971,26499,86470,0,870,574,8,0
ASSAM,UDALGURI,85751,67169,152920,30,1434,396,7,0,50742,13584,64326,30,1434,234,1,0
BIHAR,ARARIA,100000,74194,174194,50,1594,42,10,0,62048,4241,66289,0,1594,37,10,1
BIHAR,ARWAL,50500,43853,94353,50,848,53,5,0,30592,6529,37121,14,816,35,1,0
BIHAR,AURANGABAD,123115,90829,213944,50,3060,463,10,0,51815,15494,67309,23,2243,251,0,12
BIHAR,BANKA,82439,0,82439,75,2764,386,10,0,51202,18785,69987,31,2764,167,0,11
BIHAR,BEGUSARAI,192877,192877,385754,333,2156,724,10,0,168344,30700,199044,306,2086,388,80,4
BIHAR,BHAGALPUR,154950,187409,342359,50,2602,1331,10,0,88870,26513,115383,66,2602,73,2,2
BIHAR,BHOJPUR,164410,131472,295882,50,3350,319,10,0,84143,57392,141535,0,3350,319,7,7
BIHAR,BUXAR,85268,78398,163666,50,1654,96,10,0,39024,41575,80599,20,1654,96,12,3
BIHAR,DARBHANGA,360250,282960,643210,50,3492,488,10,0,142902,47022,189924,2,2388,384,23,11
BIHAR,GAYA,295670,109655,405325,50,4742,1310,10,0,110361,38062,148423,0,4530,292,10,22
BIHAR,GOPALGANJ,145610,56156,201766,50,2334,848,10,0,64575,30060,94635,10,2334,360,10,2
BIHAR,JAMUI,109377,118537,227914,50,2042,323,10,0,47479,14085,61564,2,2042,234,10,10
BIHAR,JEHANABAD,52100,40435,92535,50,1372,405,7,0,25404,10805,36209,14,1336,228,0,7
BIHAR,KAIMUR(BHABUA),82439,82641,165080,50,1810,355,10,0,48720,17944,66664,21,1810,279,0,10
BIHAR,KATIHAR,252534,150055,402589,52,2684,182,10,0,171387,39113,210500,41,2552,142,0,0
BIHAR,KHAGARIA,133528,69746,203274,50,1358,169,10,0,63656,16532,80188,47,1230,141,2,10
BIHAR,KISHANGANJ,108000,116799,224799,50,1429,88,10,0,71074,13504,84578,9,1229,88,0,26
BIHAR,LAKHISARAI,84742,74314,159056,50,988,252,7,0,37081,21641,58722,2,714,48,10,0
BIHAR,MADHEPURA,129796,119115,248911,50,1850,207,13,0,87417,23311,110728,2,1762,109,0,40
BIHAR,MADHUBANI,67482,69746,137228,63,4572,1127,10,0,67482,32611,100093,18,2832,452,5,5
BIHAR,MUNGER,86197,45296,131493,50,1334,310,10,0,25735,5032,30767,4,1286,78,0,14
BIHAR,MUZAFFARPUR,333183,278964,612147,101,5302,740,10,0,322094,59848,381942,53,5043,148,0,22
BIHAR,NALANDA,152866,157933,310799,94,3608,891,10,0,66647,21136,87783,1,2335,245,0,20
BIHAR,NAWADA,165884,69176,235060,50,2348,436,10,0,65524,14889,80413,8,2326,202,14,8
BIHAR,PASHCHIM CHAMPARAN,219434,10832,230266,50,3578,318,10,0,125571,31783,157354,0,3203,74,0,40
BIHAR,PATNA,220881,212726,433607,50,6670,553,10,0,158958,61527,220485,6,5441,317,32,67
BIHAR,PURBA CHAMPARAN,286090,246155,532245,94,4368,282,10,0,145123,24784,169907,45,3722,247,97,128
BIHAR,PURNIA,171263,282408,453671,50,2484,175,10,0,128573,30115,158688,8,2186,102,0,66
BIHAR,SAHARSA,101440,139000,240440,50,1554,256,10,0,84010,16638,100648,9,1532,115,10,14
BIHAR,SAMASTIPUR,335606,257444,593050,50,4936,559,10,0,154554,32235,186789,2,4086,559,25,25
BIHAR,SARAN,189465,283058,472523,50,3798,344,10,0,117781,62478,180259,5,3598,117,0,27
BIHAR,SASARAM(ROHTAS),180000,233378,413378,50,3208,476,10,0,100671,74777,175448,3,3208,476,0,0
BIHAR,SHEIKHPURA,44073,20595,64668,50,896,220,6,0,21602,14444,36046,4,770,127,12,0
BIHAR,SHEOHAR,58032,43996,102028,50,581,66,5,0,37069,14044,51113,5,581,66,6,0
BIHAR,SITAMARHI,294276,136865,431141,50,2750,173,10,0,46642,22732,69374,180,2678,123,15,15
BIHAR,SIWAN,234450,136765,371215,50,3124,702,10,0,106942,47666,154608,4,3124,300,6,0
BIHAR,SUPAUL,156954,136428,293382,50,1804,257,11,0,62899,11800,74699,13,1804,257,0,0
BIHAR,VAISHALI,190598,195325,385923,50,3224,518,10,0,201212,94305,295517,12,2978,487,1,95
CHHATTISGARH,BASTAR(JAGDALPUR),127241,103140,230381,50,6078,1338,14,0,69057,49079,118136,44,6573,1338,1,0
CHHATTISGARH,BILASPUR,205812,171198,377010,50,4263,1471,7,3,122513,99275,221788,23,4263,1471,10,0
CHHATTISGARH,DANTEWADA,84452,30459,114911,20,2435,1020,5,0,37876,12720,50596,12,2435,1020,2,2
CHHATTISGARH,DHAMTARI,38501,73490,111991,50,1810,321,10,0,32195,44029,76224,1,1810,321,3,3
CHHATTISGARH,DURG,101957,307630,409587,47,2436,300,10,0,65712,111515,177227,18,2735,306,12,0
CHHATTISGARH,JANJGIR - CHAMPA,111603,83716,195319,50,2908,52,10,0,70855,71121,141976,84,2908,54,0,0
CHHATTISGARH,JASHPUR,56623,76903,133526,24,3226,339,0,0,56029,45190,101219,5,3226,339,0,0
CHHATTISGARH,KANKER,50835,60565,111400,50,1737,344,10,0,41245,32889,74134,26,1737,453,0,0
CHHATTISGARH,KAWARDHA(KABIRDHAM),53025,46800,99825,12,1348,141,4,0,40750,29121,69871,12,1348,141,0,0
CHHATTISGARH,KORBA,50691,74471,125162,50,3618,1223,0,0,63983,49162,113145,17,3618,1223,5,5
CHHATTISGARH,KORIYA,38296,39493,77789,15,2282,952,5,0,30864,18345,49209,2,2282,778,0,0
CHHATTISGARH,MAHASAMUND,98828,81327,180155,50,4083,140,3,0,70358,26433,96791,3,3189,311,2,1
CHHATTISGARH,RAIGARH,128423,77298,205721,50,2007,942,0,0,75577,26100,101677,46,2007,942,0,0
CHHATTISGARH,RAIPUR,163722,277297,441019,50,4257,511,12,3,111980,91435,203415,1,4265,610,23,0
CHHATTISGARH,RAJNANDGAON,89706,117846,207552,0,5285,619,10,0,70647,81911,152558,0,5008,780,8,0
CHHATTISGARH,SURGUJA,168885,202220,371105,50,4565,498,0,0,140083,74991,215074,5,4565,498,0,0
D & N HAVELI,DADRA AND NAGAR HAVELI,2480,0,2480,12,0,0,1,0,37,0,37,1,0,0,0,0
GOA,NORTH GOA,15000,0,15000,150,283,116,0,0,15000,0,15000,0,208,8,0,0
GOA,SOUTH GOA,2935,27388,30323,0,448,431,3,0,2031,17522,19553,0,238,50,0,0
GUJARAT,AHMEDABAD,80192,169360,249552,35,920,678,31,0,80192,122225,202417,26,920,473,31,0
GUJARAT,AMRELI,67802,85978,153780,52,1131,833,10,0,62151,73559,135710,49,936,763,28,0
GUJARAT,ANAND,72058,65359,137417,52,628,488,1,0,70002,71453,141455,69,628,180,2,0
GUJARAT,BANAS KANTHA,126536,248418,374954,62,3588,1658,0,0,125652,192437,318089,70,3588,1299,12,0
GUJARAT,BHARUCH,78463,66044,144507,72,2145,1154,10,0,76055,65466,141521,51,997,883,9,0
GUJARAT,BHAVNAGAR,31305,87900,119205,54,600,1145,0,0,31591,72958,104549,100,628,839,42,0
GUJARAT,DAHOD,134798,63693,198491,87,1894,2297,0,0,131790,47474,179264,125,1894,1872,7,0
GUJARAT,DANGS,27900,16143,44043,40,216,290,0,0,27900,13382,41282,40,216,290,4,1
GUJARAT,GANDHINAGAR,13830,134168,147998,50,327,842,10,0,11332,56073,67405,49,598,757,4,0
GUJARAT,JAMNAGAR,45478,121757,167235,150,1877,1435,0,0,47864,125210,173074,75,1005,678,13,0
GUJARAT,JUNAGADH,56444,155606,212050,50,1424,515,10,0,55887,129488,185375,58,1424,518,14,0
GUJARAT,KACHCHH,45596,172755,218351,84,1534,377,10,0,37781,91084,128865,100,1372,315,10,0
GUJARAT,KHEDA,140212,158858,299070,81,2699,2284,10,0,138941,172506,311447,89,2699,2132,22,1
GUJARAT,MAHESANA,61499,175540,237039,53,1995,1128,10,0,61938,186956,248894,53,706,970,10,0
GUJARAT,NARMADA,58730,17385,76115,100,659,757,0,0,57297,16985,74282,5,659,550,6,0
GUJARAT,NAVSARI,75015,91094,166109,45,1347,1369,10,0,75015,79630,154645,52,1347,1118,5,2
GUJARAT,PANCH MAHALS,156835,223369,380204,61,3272,1578,22,0,153720,142680,296400,91,3272,1400,23,0
GUJARAT,PATAN,58741,122970,181711,58,760,773,10,0,60055,108463,168518,42,762,773,10,0
GUJARAT,PORBANDAR,17024,49264,66288,64,715,178,4,0,17024,37184,54208,64,462,128,4,0
GUJARAT,RAJKOT,78753,187031,265784,71,2532,820,10,0,79437,116938,196375,129,2400,820,14,0
GUJARAT,SABAR KANTHA,151382,297657,449039,63,3611,1304,0,0,151382,212899,364281,31,3577,1304,10,0
GUJARAT,SURAT,158797,155542,314339,51,1878,2443,0,0,158797,145366,304163,55,1878,2144,22,0
GUJARAT,SURENDRANAGAR,83235,181248,264483,55,727,1024,0,0,70294,128222,198516,136,727,850,41,0
GUJARAT,VADODARA,140958,243750,384708,50,2929,3748,10,0,129194,120819,250013,100,2854,3233,18,0
GUJARAT,VALSAD,85274,40741,126015,131,1031,1398,0,0,109073,61209,170282,115,978,1145,6,1
HARYANA,AMBALA,43428,67548,110976,65,576,591,6,0,39530,66071,105601,66,576,591,6,0
HARYANA,BHIWANI,48947,70327,119274,50,344,587,0,0,49247,77427,126674,50,344,587,1,0
HARYANA,FARIDABAD,22254,83065,105319,76,310,640,5,1,22254,77257,99511,76,338,640,6,1
HARYANA,FATEHABAD,25642,58681,84323,80,762,460,0,0,25361,56928,82289,65,762,460,6,1
HARYANA,GURGAON,10522,51888,62410,59,492,399,0,0,14822,51951,66773,59,492,399,0,0
HARYANA,HISAR,46463,101738,148201,65,805,391,0,0,46463,101738,148201,54,830,430,9,0
HARYANA,JHAJJAR,22014,72731,94745,67,160,655,0,0,22014,72731,94745,67,160,655,5,0
HARYANA,JIND,58000,120534,178534,82,233,448,0,0,57351,118674,176025,59,248,448,7,0
HARYANA,KAITHAL,37046,46392,83438,83,253,8,0,0,36566,63545,100111,83,253,8,0,0
HARYANA,KARNAL,45973,126699,172672,76,970,582,0,0,46015,124136,170151,76,970,582,5,0
HARYANA,KURUKSHETRA,30598,67780,98378,100,563,465,0,0,30681,67807,98488,100,563,465,5,0
HARYANA,MAHENDRAGARH,17500,80000,97500,81,253,554,0,0,17500,80000,97500,81,253,554,1,0
HARYANA,MEWAT,21875,99024,120899,50,497,185,0,0,20100,47743,67843,50,497,185,5,0
HARYANA,PANCHKULA,8760,18801,27561,58,126,68,0,0,8760,18801,27561,58,126,97,3,0
HARYANA,PANIPAT,28000,39720,67720,64,182,216,0,0,28000,39720,67720,60,235,216,10,1
HARYANA,REWARI,30000,66388,96388,50,694,0,0,0,26548,64704,91252,49,696,19,5,0
HARYANA,ROHTAK,22171,79851,102022,79,156,17,0,0,22171,79851,102022,79,158,17,2,2
HARYANA,SIRSA,35400,28111,63511,50,400,354,0,0,35400,28111,63511,50,400,354,4,0
HARYANA,SONIPAT,29808,94725,124533,50,100,368,5,0,30300,134800,165100,50,100,368,5,4
HARYANA,YAMUNANAGAR,52539,84491,137030,50,1284,611,0,0,51915,84491,136406,50,1284,611,10,0
HIMACHAL PRADESH,BILASPUR,11931,38738,50669,100,957,500,6,0,13221,39436,52657,51,820,466,0,0
HIMACHAL PRADESH,CHAMBA,44429,31646,76075,50,1778,105,10,0,58422,40186,98608,50,1778,158,0,0
HIMACHAL PRADESH,HAMIRPUR,11593,45592,57185,60,1400,900,3,0,11593,45683,57276,39,1071,685,1,0
HIMACHAL PRADESH,KANGRA,45000,159201,204201,116,4000,4200,4,0,61930,269640,331570,59,2834,3953,1,0
HIMACHAL PRADESH,KINNAUR,1560,13383,14943,65,350,226,1,0,1560,13263,14823,28,272,66,0,0
HIMACHAL PRADESH,KULLU,9989,41986,51975,150,1150,956,2,0,9989,45940,55929,113,1150,942,0,0
HIMACHAL PRADESH,LAHAUL & SPITI,2413,3049,5462,4,263,112,1,0,2413,3049,5462,4,263,112,1,0
HIMACHAL PRADESH,MANDI,34407,117797,152204,100,3409,224,10,0,34408,117797,152205,125,3434,124,5,0
HIMACHAL PRADESH,SHIMLA,23874,53231,77105,70,2489,923,10,0,24194,54848,79042,70,2489,840,0,0
HIMACHAL PRADESH,SIRMAUR,13753,44978,58731,264,2804,223,6,0,13671,70126,83797,75,1852,223,6,2
HIMACHAL PRADESH,SOLAN,10858,38230,49088,225,1288,1244,4,0,10858,38230,49088,207,1288,1244,1,0
HIMACHAL PRADESH,UNA,8360,44752,53112,25,850,695,2,0,8360,44752,53112,25,850,695,5,0
JAMMU & KASHMIR,ANANTNAG,75476,18061,93537,50,1315,75,3,0,61938,19199,81137,50,1315,9,0,0
JAMMU & KASHMIR,BANDIPORA,13100,31466,44566,10,360,10,10,0,5725,0,5725,7,127,0,0,0
JAMMU & KASHMIR,BARAMULLA,68290,64211,132501,52,1164,22,8,0,31989,18302,50291,49,1164,2,0,0
JAMMU & KASHMIR,BUDGAM,47801,24580,72381,77,1296,37,6,0,21126,8500,29626,77,1176,6,0,0
JAMMU & KASHMIR,DODA,73029,25779,98808,50,4033,23,10,4,39930,8689,48619,100,2819,20,0,0
JAMMU & KASHMIR,JAMMU,50950,113373,164323,50,2607,36,6,0,16524,28035,44559,50,2165,36,2,0
JAMMU & KASHMIR,KARGIL,8475,0,8475,55,1545,10,5,0,2970,600,3570,30,706,1,0,0
JAMMU & KASHMIR,KATHUA,25978,64408,90386,60,1049,33,7,0,10098,26341,36439,53,1048,10,1,0
JAMMU & KASHMIR,KISHTWAR,22318,0,22318,10,1285,0,0,0,6754,0,6754,5,525,0,0,0
JAMMU & KASHMIR,KULGAM,11568,27306,38874,10,286,15,0,0,7078,4000,11078,10,236,15,0,0
JAMMU & KASHMIR,KUPWARA,58068,18208,76276,50,2359,105,6,0,27947,4672,32619,47,1692,13,2,0
JAMMU & KASHMIR,LEH (LADAKH),6090,0,6090,250,351,400,3,0,5296,0,5296,240,350,132,0,0
JAMMU & KASHMIR,POONCH,37764,27507,65271,82,1560,51,6,0,20072,11097,31169,80,1242,5,0,0
JAMMU & KASHMIR,PULWAMA,41902,13141,55043,64,1384,48,6,0,13933,9710,23643,64,1223,7,4,0
JAMMU & KASHMIR,RAJAURI,37507,223960,261467,12,1241,5,2,0,8664,15595,24259,12,1224,6,1,0
JAMMU & KASHMIR,RAMBAN,15926,6850,22776,34,1014,25,4,0,1986,0,1986,18,356,2,0,0
JAMMU & KASHMIR,REASI,21500,0,21500,10,854,50,4,0,4266,0,4266,12,388,8,0,0
JAMMU & KASHMIR,SAMBA,9849,0,9849,10,70,20,0,0,1100,0,1100,10,45,5,0,0
JAMMU & KASHMIR,SHOPIAN,10196,0,10196,10,300,10,2,0,2498,342,2840,16,95,0,1,0
JAMMU & KASHMIR,SRINAGAR,18434,64408,82842,78,274,70,4,0,9694,18242,27936,82,191,6,4,0
JAMMU & KASHMIR,UDHAMPUR,48850,44474,93324,56,2930,25,7,0,18322,7265,25587,43,2088,22,0,0
JHARKHAND,BOKARO,104627,102176,206803,40,1814,249,8,0,34201,5985,40186,6,1808,249,14,14
JHARKHAND,CHATRA,98223,25280,123503,50,1134,526,10,0,54229,3662,57891,19,1134,242,16,16
JHARKHAND,DEOGHAR,75153,88207,163360,50,464,1057,10,0,75153,20310,95463,1,464,869,0,15
JHARKHAND,DHANBAD,104672,89302,193974,62,2820,73,10,0,45375,15862,61237,24,2820,102,0,12
JHARKHAND,DUMKA,148732,42024,190756,50,2926,202,10,0,126910,13698,140608,0,2926,202,72,73
JHARKHAND,GARHWA,95558,69177,164735,50,1303,714,10,0,59143,3407,62550,25,1373,82,20,25
JHARKHAND,GIRIDIH,155100,44190,199290,50,2472,1762,10,0,66587,5610,72197,10,2472,368,0,13
JHARKHAND,GODDA,95732,114088,209820,50,1612,315,10,0,46333,5595,51928,14,1612,248,13,14
JHARKHAND,GUMLA,97098,101793,198891,50,1190,307,10,0,54968,6931,61899,3,1190,307,19,19
JHARKHAND,HAZARIBAGH,140453,71402,211855,105,1563,169,15,0,103890,10752,114642,29,1563,169,15,45
JHARKHAND,JAMTARA,68040,62374,130414,50,626,620,10,0,42261,3905,46166,1,626,223,0,10
JHARKHAND,KHUNTI,45773,11493,57266,12,1791,196,12,0,12590,1085,13675,0,1232,177,2,0
JHARKHAND,KODERMA,39950,37106,77056,50,472,440,10,0,20925,495,21420,0,440,317,4,12
JHARKHAND,LATEHAR,79635,14552,94187,50,2058,649,16,0,66455,5140,71595,27,2058,649,0,40
JHARKHAND,LOHARDAGA,22626,25229,47855,50,626,307,10,0,22626,16558,39184,10,626,307,0,6
JHARKHAND,PAKUR,72250,29077,101327,50,1601,685,10,0,63306,7064,70370,0,1601,202,0,52
JHARKHAND,PALAMU,91152,138623,229775,50,1927,99,10,0,69009,16560,85569,8,1928,99,13,13
JHARKHAND,PASCHIM SINGHBHUM,170083,33439,203522,50,3063,361,10,0,80833,3968,84801,38,3064,361,13,20
JHARKHAND,PURBI SINGHBHUM,97196,119789,216985,52,2248,337,10,0,126967,20358,147325,3,2248,337,0,21
JHARKHAND,RAMGARH,48992,16857,65849,40,670,40,8,0,18826,1018,19844,1,512,40,0,0
JHARKHAND,RANCHI,197639,41036,238675,42,5900,1032,10,0,127487,14105,141592,28,3203,607,10,50
JHARKHAND,SAHIBGANJ,112798,12484,125282,50,1238,800,10,0,65730,11635,77365,23,1238,800,8,8
JHARKHAND,SERAIKELA KHARSAWAN,105319,62645,167964,50,1752,357,10,0,42981,5332,48313,0,1752,357,2,25
JHARKHAND,SIMDEGA,60505,49846,110351,50,1417,175,10,0,19152,2053,21205,0,1417,175,13,13
KARNATAKA,BAGALKOT,74926,175385,250311,58,745,1118,10,0,69007,142154,211161,48,995,1172,7,0
KARNATAKA,BANGALORE RURAL,63044,39979,103023,10,1420,414,5,0,87975,69207,157182,12,2706,915,0,0
KARNATAKA,BANGALORE URBAN,71892,28299,100191,50,86,454,10,0,41591,27415,69006,32,86,454,0,0
KARNATAKA,BELGAUM,196594,501172,697766,50,3290,1962,10,0,140880,318912,459792,50,3380,2023,1,0
KARNATAKA,BELLARY,100252,85854,186106,93,859,582,2,0,69004,45427,114431,100,1071,818,0,0
KARNATAKA,BIDAR,58384,125768,184152,51,1426,1165,10,0,36982,68834,105816,12,1426,1165,1,1
KARNATAKA,BIJAPUR,127172,108608,235780,50,2129,1793,10,0,57180,56205,113385,24,2129,585,4,1
KARNATAKA,CHAMARAJANAGAR,110188,28797,138985,50,369,1269,10,0,69401,21465,90866,19,288,938,8,1
KARNATAKA,CHICKMAGALUR,67568,70603,138171,35,1852,764,10,0,65463,82048,147511,9,1852,776,10,1
KARNATAKA,CHIKBALLAPUR,89907,36479,126386,12,941,42,6,0,64591,34973,99564,10,1569,1052,3,0
KARNATAKA,CHITRADURGA,75400,130585,205985,50,1422,1021,22,6,74510,59511,134021,50,1452,1166,6,2
KARNATAKA,DAVANGERE,122530,129754,252284,50,1385,972,10,0,91857,118431,210288,50,1326,972,10,0
KARNATAKA,DHARWAD,53596,60267,113863,25,930,1051,10,0,50223,49543,99766,21,769,628,5,0
KARNATAKA,GADAG,46821,39520,86341,50,291,431,10,0,40119,28708,68827,40,484,431,5,0
KARNATAKA,GULBARGA,269726,172264,441990,50,4024,2232,10,0,163238,49472,212710,27,4024,2228,100,0
KARNATAKA,HASSAN,64134,216283,280417,50,1902,1173,10,0,64134,206238,270372,35,1914,1217,8,0
KARNATAKA,HAVERI,98436,57875,156311,53,818,785,10,0,66161,43515,109676,42,818,747,7,1
KARNATAKA,KODAGU,38838,18095,56933,50,179,287,9,0,38838,18095,56933,39,180,292,1,0
KARNATAKA,KOLAR,43183,83210,126393,12,981,64,5,0,86051,96356,182407,3,1630,2331,0,0
KARNATAKA,KOPPAL,60869,177618,238487,50,870,987,3,0,53660,103645,157305,50,902,787,2,1
KARNATAKA,MANDYA,128782,148152,276934,50,1631,914,10,0,117050,142902,259952,25,1631,914,10,0
KARNATAKA,MANGALORE(DAKSHINA KANNADA),59478,35532,95010,70,1236,505,15,0,59478,35532,95010,70,1236,505,0,0
KARNATAKA,MYSORE,160601,42639,203240,54,1059,656,20,0,112765,96556,209321,10,2482,931,2,2
KARNATAKA,RAICHUR,104887,120627,225514,52,1464,230,10,0,36429,23008,59437,49,1464,557,10,4
KARNATAKA,RAMANAGARA,41876,58807,100683,10,1186,501,0,0,37691,40368,78059,10,1187,501,0,0
KARNATAKA,SHIMOGA,99428,40151,139579,50,1616,986,23,0,99996,45802,145798,40,1276,1030,7,1
KARNATAKA,TUMKUR,242872,137654,380526,50,2242,1845,10,0,149410,117829,267239,40,2762,2023,2,0
KARNATAKA,UDUPI,52348,34286,86634,20,618,431,10,0,52421,34313,86734,16,519,425,0,0
KARNATAKA,UTTAR KANNADA,165492,77428,242920,50,2296,1719,10,0,120720,66599,187319,47,2314,1280,10,0
KERALA,ALAPPUZHA,114359,2189,116548,107,166,246,10,0,114359,4500,118859,107,166,246,10,10
KERALA,ERNAKULAM,54585,16069,70654,62,365,394,9,0,55916,16219,72135,62,365,394,7,2
KERALA,IDUKKI,86535,11880,98415,51,116,188,4,0,89553,13823,103376,76,156,248,0,0
KERALA,KANNUR,34121,0,34121,56,168,350,5,0,37628,18269,55897,40,174,374,3,3
KERALA,KASARGOD,56965,23300,80265,57,281,382,4,0,59153,23300,82453,36,281,382,1,0
KERALA,KOLLAM,95130,7290,102420,400,410,351,10,0,95130,7290,102420,400,422,352,6,6
KERALA,KOTTAYAM,28118,1646,29764,40,182,133,5,0,28118,1840,29958,40,182,133,0,0
KERALA,KOZHIKODE,42285,2086,44371,30,253,250,7,0,42285,2140,44425,19,253,250,2,0
KERALA,MALAPPURAM,60592,3996,64588,55,448,272,10,0,61905,7850,69755,34,466,272,14,1
KERALA,PALAKKAD,107018,24424,131442,49,289,520,7,0,107018,24424,131442,49,289,520,6,0
KERALA,PATHANAMTHITTA,53799,1200,54999,25,172,121,5,0,53799,1200,54999,25,172,121,0,0
KERALA,THIRUVANANTHAPURAM,129000,9482,138482,58,350,817,10,0,137004,12496,149500,70,383,817,10,0
KERALA,THRISSUR,48669,5868,54537,59,316,839,9,0,51017,7051,58068,48,316,839,5,2
KERALA,WAYANAD,50655,2481,53136,41,84,94,3,0,50655,2481,53136,41,84,94,3,0
MADHYA PRADESH,ALIRAJPUR,38225,37210,75435,9,2140,586,9,1,52971,50259,103230,8,3067,751,6,0
MADHYA PRADESH,ANUPPUR,39615,72695,112310,26,1984,1007,4,0,55873,67074,122947,34,2382,1007,4,0
MADHYA PRADESH,ASHOKNAGAR,54450,51854,106304,0,2362,130,0,0,29526,43512,73038,0,2690,180,0,0
MADHYA PRADESH,BALAGHAT,171243,105357,276600,54,2852,1989,7,1,136631,98826,235457,45,3056,1670,8,1
MADHYA PRADESH,BARWANI,75695,49508,125203,41,2666,1846,6,1,85654,50742,136396,9,3223,1169,6,1
MADHYA PRADESH,BETUL,43427,117664,161091,38,2412,455,10,0,44059,68628,112687,28,2677,512,2,1
MADHYA PRADESH,BHIND,42573,148810,191383,31,2460,160,5,1,21319,29042,50361,14,2771,113,0,0
MADHYA PRADESH,BHOPAL,20010,39539,59549,20,589,165,4,0,34907,37373,72280,2,593,138,2,0
MADHYA PRADESH,BURHANPUR,41047,48092,89139,18,971,349,0,0,45079,43330,88409,31,818,155,4,0
MADHYA PRADESH,CHHATARPUR,74861,165480,240341,62,3068,240,4,1,43847,51043,94890,25,3744,253,4,4
MADHYA PRADESH,CHHINDWARA,116436,186478,302914,50,6107,418,10,0,70656,106921,177577,47,6198,418,4,0
MADHYA PRADESH,DAMOH,99131,78822,177953,50,1944,158,6,1,67861,25784,93645,21,2860,83,7,1
MADHYA PRADESH,DATIA,11997,35651,47648,30,2155,70,2,1,18549,35048,53597,2,1488,93,1,2
MADHYA PRADESH,DEWAS,59245,106423,165668,50,1927,25,9,1,80182,96062,176244,42,2316,29,4,0
MADHYA PRADESH,DHAR,100281,98820,199101,52,3503,490,9,1,119944,153500,273444,18,3626,620,9,0
MADHYA PRADESH,DINDORI,63701,63086,126787,12,1708,750,6,1,61360,54736,116096,10,1958,750,7,1
MADHYA PRADESH,GUNA,53901,60419,114320,10,3664,86,9,1,43510,54341,97851,10,2476,143,5,1
MADHYA PRADESH,GWALIOR,32128,111287,143415,53,1897,142,4,0,39292,75834,115126,23,2260,142,2,0
MADHYA PRADESH,HARDA,23589,46014,69603,5,1742,223,3,1,31858,38625,70483,5,921,285,2,0
MADHYA PRADESH,HOSHANGABAD,50677,76631,127308,78,1686,725,10,0,83469,70611,154080,40,2244,725,7,0
MADHYA PRADESH,INDORE,48998,114548,163546,20,1502,721,10,0,50431,114860,165291,20,1950,831,24,0
MADHYA PRADESH,JABALPUR,106290,88024,194314,44,2240,260,9,1,117944,79784,197728,44,3155,347,13,0
MADHYA PRADESH,JHABUA,81491,32863,114354,9,2140,586,9,1,94747,83387,178134,12,4485,804,12,0
MADHYA PRADESH,KATNI,53000,117095,170095,15,2079,921,5,1,68737,68602,137339,11,2079,770,2,0
MADHYA PRADESH,KHANDWA(EAST NIMAR),60123,58327,118450,40,2960,1375,8,0,82792,79489,162281,6,2373,1229,8,7
MADHYA PRADESH,KHARGONE,91083,152741,243824,50,3498,687,9,1,93241,155299,248540,31,3498,687,4,0
MADHYA PRADESH,MANDLA,98650,73826,172476,0,3064,176,10,0,83735,42642,126377,2,2105,406,3,0
MADHYA PRADESH,MANDSAUR,46666,119498,166164,50,1092,341,10,0,68013,117833,185846,46,1668,430,10,0
MADHYA PRADESH,MORENA,32478,169027,201505,50,2151,142,6,1,39914,96584,136498,37,3090,136,7,0
MADHYA PRADESH,NARSINGHPUR,67857,58600,126457,78,1720,913,6,0,66894,56593,123487,52,2207,913,6,0
MADHYA PRADESH,NEEMUCH,27790,86180,113970,39,1412,103,9,1,42857,82827,125684,33,1697,165,2,1
MADHYA PRADESH,PANNA,72600,186451,259051,15,9254,117,9,1,56548,48946,105494,10,2782,117,4,0
MADHYA PRADESH,RAISEN,88825,86117,174942,27,3000,869,10,0,102867,81191,184058,36,3274,876,10,0
MADHYA PRADESH,RAJGARH,94365,80166,174531,44,3206,244,10,0,116246,65909,182155,43,3622,244,33,0
MADHYA PRADESH,RATLAM,51248,88719,139967,24,1392,158,5,1,64627,82493,147120,10,2029,158,11,2
MADHYA PRADESH,REWA,121538,197742,319280,9,8902,2153,10,0,148894,122110,271004,18,6928,211,9,0
MADHYA PRADESH,SAGAR,208079,137113,345192,22,3749,139,10,1,120671,91401,212072,22,5317,302,10,2
MADHYA PRADESH,SATNA,225199,119149,344348,66,3358,1845,7,1,174071,100345,274416,42,4966,1845,5,0
MADHYA PRADESH,SEHORE,34355,86987,121342,4,3230,62,10,0,78904,72588,151492,4,2729,137,13,0
MADHYA PRADESH,SEONI,104769,122727,227496,10,2794,1718,4,0,93557,81252,174809,5,2780,890,22,0
MADHYA PRADESH,SHAHDOL,84802,74157,158959,45,2500,878,8,1,86605,69487,156092,35,3669,849,14,1
MADHYA PRADESH,SHAJAPUR,65429,91295,156724,18,3259,313,7,1,75360,87184,162544,17,2100,288,8,1
MADHYA PRADESH,SHEOPUR,18198,63230,81428,10,1054,189,9,1,29182,44695,73877,9,964,189,2,1
MADHYA PRADESH,SHIVPURI,65212,149252,214464,52,2814,148,7,1,46994,94979,141973,20,3594,148,3,0
MADHYA PRADESH,SIDHI,127045,68292,195337,20,1458,488,8,1,65297,53290,118587,9,2971,488,4,0
MADHYA PRADESH,SINGRAULI,53722,98994,152716,7,1936,472,3,0,53722,39623,93345,7,2975,468,3,0
MADHYA PRADESH,TIKAMGARH,66866,97843,164709,30,5086,112,6,0,44678,43374,88052,5,3940,110,9,1
MADHYA PRADESH,UJJAIN,68225,166634,234859,50,3800,1006,10,0,78159,115778,193937,45,2843,1006,16,3
MADHYA PRADESH,UMARIA,40359,78621,118980,51,2303,300,9,1,54778,64522,119300,39,2471,326,2,1
MADHYA PRADESH,VIDISHA,96852,88789,185641,14,2940,145,6,1,84923,69289,154212,43,2741,145,12,0
MAHARASHTRA,AHMEDNAGAR,134247,304214,438461,50,2800,3646,14,0,132541,309178,441719,50,2800,3339,14,0
MAHARASHTRA,AKOLA,81443,106045,187488,0,1547,1000,7,0,57515,66620,124135,3,1547,1000,14,5
MAHARASHTRA,AMRAVATI,176172,133894,310066,108,1587,1801,10,0,98878,78712,177590,67,1587,1664,11,2
MAHARASHTRA,AURANGABAD,110190,174106,284296,154,1787,1810,10,0,61337,120991,182328,170,1787,1810,20,0
MAHARASHTRA,BEED,90500,385000,475500,53,3154,1614,10,0,57972,108976,166948,143,3154,2108,45,0
MAHARASHTRA,BHANDARA,93065,39555,132620,45,1347,1081,5,2,81806,63626,145432,45,1347,1081,10,2
MAHARASHTRA,BULDHANA,117275,208512,325787,70,2730,1833,28,0,71353,75434,146787,70,2730,2310,25,5
MAHARASHTRA,CHANDRAPUR,143479,148429,291908,66,2022,1833,25,0,113952,105198,219150,55,2022,1833,22,0
MAHARASHTRA,DHULE,106598,77574,184172,142,1473,1489,10,0,85946,71941,157887,142,1473,1793,96,4
MAHARASHTRA,GADCHIROLI,75900,53113,129013,54,1278,1321,9,3,76364,42372,118736,54,1278,1321,24,0
MAHARASHTRA,GONDIA,120714,59502,180216,175,1731,1298,6,2,114065,57388,171453,69,1731,1298,20,0
MAHARASHTRA,HINGOLI,52157,146643,198800,200,1797,910,9,1,48126,107722,155848,200,1797,910,9,1
MAHARASHTRA,JALGAON,214260,304787,519047,725,3627,2618,15,0,131914,161569,293483,725,3627,2802,15,0
MAHARASHTRA,JALNA,85470,139011,224481,124,2200,1550,8,0,83138,129709,212847,75,2200,1550,8,0
MAHARASHTRA,KOLHAPUR,75993,322439,398432,985,2210,3167,10,0,60990,322439,383429,947,2510,3964,25,0
MAHARASHTRA,LATUR,74260,200093,274353,115,2556,1017,8,2,47104,91674,138778,50,2556,1181,14,0
MAHARASHTRA,NAGPUR,67367,182311,249678,300,2219,1775,10,0,59814,148924,208738,192,2219,1649,67,13
MAHARASHTRA,NANDED,101990,189813,291803,69,4432,2695,10,0,57169,98629,155798,19,4432,2695,16,0
MAHARASHTRA,NANDURBAR,134118,79135,213253,132,2216,866,6,0,75548,30668,106216,77,2216,1211,6,0
MAHARASHTRA,NASHIK,202284,249900,452184,54,2072,3427,12,3,150249,193091,343340,41,2072,2073,31,0
MAHARASHTRA,OSMANABAD,54312,144344,198656,57,1689,752,3,1,54327,89014,143341,30,1689,981,26,1
MAHARASHTRA,PARBHANI,53647,200093,253740,56,1540,863,6,3,47092,68143,115235,29,1540,1263,12,0
MAHARASHTRA,PUNE,97302,305917,403219,633,5684,2480,10,0,95368,303252,398620,331,5684,3680,46,1
MAHARASHTRA,RAIGAD,124656,183838,308494,500,4915,1931,10,0,98670,193764,292434,603,4915,2131,22,0
MAHARASHTRA,RATNAGIRI,95726,222099,317825,575,4167,1147,10,0,102382,161470,263852,541,4167,1812,9,0
MAHARASHTRA,SANGLI,50210,199976,250186,900,3274,2151,10,0,41990,179061,221051,304,3274,2278,25,2
MAHARASHTRA,SATARA,83517,306199,389716,852,4419,3431,10,0,71963,299910,371873,852,4878,3650,49,0
MAHARASHTRA,SINDHUDURG,43874,73459,117333,460,2292,1050,3,1,43874,73459,117333,460,2292,1101,17,0
MAHARASHTRA,SOLAPUR,167757,291036,458793,52,4045,3378,9,1,117462,250626,368088,22,4045,3378,11,0
MAHARASHTRA,THANE,235922,299502,535424,300,4883,2616,10,3,226374,297341,523715,300,4883,2616,16,3
MAHARASHTRA,WARDHA,63339,71069,134408,56,1298,852,6,2,59350,61233,120583,38,1298,852,10,6
MAHARASHTRA,WASHIM,107896,97057,204953,50,1526,950,4,2,47763,47923,95686,38,1684,1075,4,0
MAHARASHTRA,YAVATMAL,187799,206239,394038,98,2935,1724,16,0,87450,115691,203141,76,2935,1946,32,4
MANIPUR,BISHNUPUR,12152,4850,17002,24,302,84,2,0,10680,4450,15130,24,302,84,0,3
MANIPUR,CHANDEL,17610,0,17610,50,434,182,5,0,13500,0,13500,45,434,182,0,0
MANIPUR,CHURACHANDPUR,33864,3762,37626,50,676,190,7,0,16555,3762,20317,37,676,190,5,0
MANIPUR,IMPHAL EAST,13189,12030,25219,50,804,119,3,0,12550,6815,19365,52,804,119,3,0
MANIPUR,IMPHAL WEST,20608,4405,25013,45,156,0,5,0,16434,3509,19943,40,156,0,6,0
MANIPUR,SENAPATI,47968,28392,76360,50,490,185,1,0,29332,13181,42513,26,490,185,0,0
MANIPUR,TAMENGLONG,13380,1486,14866,50,424,0,4,0,11968,1486,13454,40,424,0,0,0
MANIPUR,THOUBAL,23264,5250,28514,42,395,42,3,0,18411,5250,23661,42,395,42,3,0
MANIPUR,UKHRUL,12852,8192,21044,25,238,399,5,0,1364,8192,9556,2,238,399,0,0
MEGHALAYA,EAST GARO HILLS,31739,6469,38208,10,1311,177,10,0,21924,9750,31674,25,1131,177,6,0
MEGHALAYA,EAST KHASI HILLS,42284,32778,75062,50,2148,349,4,0,32887,27645,60532,52,2148,380,0,0
MEGHALAYA,JAINTIA HILLS,31950,6729,38679,50,595,155,5,0,20452,4585,25037,26,493,141,5,0
MEGHALAYA,RI BHOI,16276,21196,37472,50,1946,305,3,0,13741,12275,26016,38,1946,290,0,0
MEGHALAYA,SOUTH GARO HILLS,12891,5346,18237,30,1074,227,4,0,11670,3199,14869,21,474,129,0,0
MEGHALAYA,WEST GARO HILLS,44385,11179,55564,50,2244,448,4,0,44385,8700,53085,6,1447,388,1,0
MEGHALAYA,WEST KHASI HILLS,36808,1803,38611,50,1013,190,6,0,20760,1803,22563,31,1953,244,0,0
MIZORAM,AIZAWL,16525,3497,20022,60,1025,454,5,0,11101,3136,14237,59,634,401,0,0
MIZORAM,CHAMPHAI,11077,1949,13026,54,1097,282,3,0,11077,1949,13026,50,824,282,0,0
MIZORAM,KOLASIB,8833,720,9553,20,360,97,3,0,8833,400,9233,21,294,97,0,0
MIZORAM,LAWNGTLAI,16544,2773,19317,149,908,141,2,0,16544,2773,19317,149,396,141,0,0
MIZORAM,LUNGLEI,19280,4665,23945,150,1287,218,3,0,17229,4665,21894,158,663,128,0,0
MIZORAM,MAMIT,5459,2000,7459,50,734,222,0,0,5334,2000,7334,46,352,219,0,0
MIZORAM,SAIHA,7238,567,7805,0,214,99,2,0,6417,567,6984,0,169,10,0,0
MIZORAM,SERCHHIP,4947,2804,7751,77,280,117,2,0,4398,2804,7202,77,80,92,0,0
NAGALAND,DIMAPUR,28927,3331,32258,0,450,215,3,0,21364,3131,24495,8,328,186,1,0
NAGALAND,KIPHIRE,14316,78,14394,10,194,77,4,0,0,78,78,0,0,0,0,0
NAGALAND,KOHIMA,25610,13063,38673,189,365,184,3,0,23981,10776,34757,178,285,184,2,0
NAGALAND,LONGLENG,6438,0,6438,8,26,40,2,0,0,0,0,0,0,0,0,0
NAGALAND,MOKOKCHUNG,11000,2312,13312,10,430,110,2,0,10662,2312,12974,5,250,135,0,0
NAGALAND,MON,20631,7839,28470,17,368,99,2,0,11627,6832,18459,8,214,81,2,0
NAGALAND,PEREN,9018,2325,11343,6,95,148,3,0,6802,2002,8804,3,178,102,1,0
NAGALAND,PHEK,18742,1160,19902,11,155,89,2,0,16299,1086,17385,7,292,73,2,0
NAGALAND,TUENSANG,13027,0,13027,5,214,81,3,0,10008,0,10008,5,220,52,1,0
NAGALAND,WOKHA,11813,1146,12959,7,134,196,3,0,7266,1038,8304,5,60,44,1,0
NAGALAND,ZUNHEBOTO,20570,0,20570,12,541,63,2,0,14840,0,14840,1,358,148,1,0
ORISSA,ANGUL,109581,77228,186809,24,2040,795,10,0,62039,36876,98915,4,2040,795,32,32
ORISSA,BALANGIR,199853,142381,342234,28,2400,915,10,0,118150,23986,142136,4,2400,915,6,7
ORISSA,BALESWAR,281636,102367,384003,48,3787,1849,10,0,257671,99600,357271,16,3994,1849,37,48
ORISSA,BARGARH,175810,140072,315882,0,2393,361,10,0,120630,72004,192634,0,2443,388,0,4
ORISSA,BHADRAK,136849,81632,218481,0,1855,1190,8,0,86521,44397,130918,0,1844,1109,0,75
ORISSA,BOUDH,71702,20970,92672,3,1033,258,10,0,41705,9583,51288,0,1015,258,9,1
ORISSA,CUTTACK,178679,186195,364874,50,2426,42,10,0,124061,102940,227001,16,2485,155,0,120
ORISSA,DEBAGARH,42977,19981,62958,20,620,190,10,0,26969,13355,40324,0,654,221,0,6
ORISSA,DHENKANAL,125111,65196,190307,32,2065,690,10,0,71585,26923,98508,3,2065,684,30,30
ORISSA,GAJAPATI,68154,42038,110192,14,1438,630,10,0,35491,9517,45008,0,1332,610,0,35
ORISSA,GANJAM,270886,180430,451316,20,4235,2505,10,0,174588,103218,277806,11,4203,2505,72,93
ORISSA,JAGATSINGHAPUR,95623,116710,212333,16,2434,955,10,0,91601,87331,178932,8,2434,955,10,16
ORISSA,JAJAPUR,162500,191899,354399,50,3414,1355,10,0,87854,114316,202170,0,3414,1355,0,101
ORISSA,JHARSUGUDA,33172,34757,67929,30,811,433,10,0,23459,13210,36669,2,811,433,0,16
ORISSA,KALAHANDI,190958,105415,296373,50,2330,676,10,0,96701,62455,159156,0,2330,676,0,50
ORISSA,KANDHAMAL,112422,43118,155540,0,1812,937,5,0,33443,6069,39512,5,1785,635,21,10
ORISSA,KENDRAPARA,136153,80039,216192,9,2583,1064,10,0,94142,56909,151051,4,2624,1064,29,0
ORISSA,KENDUJHAR,219850,43598,263448,50,5428,1590,10,0,80324,16943,97267,0,5184,820,1,8
ORISSA,KHORDHA,150000,80593,230593,50,2431,150,8,0,103119,31550,134669,1,2431,184,8,0
ORISSA,KORAPUT,221421,42780,264201,50,2659,1130,10,0,101968,6407,108375,0,2604,1013,0,10
ORISSA,MALKANGIRI,89117,42591,131708,50,1650,534,10,0,57180,28499,85679,2,1635,522,0,1
ORISSA,MAYURBHANJ,369475,193293,562768,10,4642,1698,10,0,272816,52300,325116,1,4642,1894,0,60
ORISSA,NABARANGAPUR,158604,95891,254495,50,1838,378,10,0,62576,30564,93140,0,2251,961,0,0
ORISSA,NAYAGARH,134750,72562,207312,51,1993,34,8,0,89766,18040,107806,7,1993,552,0,0
ORISSA,NUAPADA,101492,27298,128790,20,941,585,10,0,47375,13319,60694,6,941,585,10,0
ORISSA,PURI,160972,70160,231132,50,2250,1130,10,0,102358,28206,130564,28,2183,1136,8,0
ORISSA,RAYAGADA,134397,77807,212204,25,2931,1001,10,0,69107,3954,73061,0,2061,478,15,0
ORISSA,SAMBALPUR,88701,59914,148615,0,2217,480,10,0,53585,21089,74674,0,2217,480,0,0
ORISSA,SONEPUR,80396,26722,107118,0,1563,214,10,0,51296,13394,64690,0,1587,214,5,0
ORISSA,SUNDARGARH,183809,107961,291770,18,2444,1391,10,0,139891,28630,168521,3,2821,1496,0,6
PUDUCHERRY,PONDICHERRY,18000,0,18000,0,26,16,3,0,2268,0,2268,30,0,16,2,0
PUNJAB,AMRITSAR,90089,66983,157072,0,599,378,0,0,2716,84262,86978,1,650,50,0,0
PUNJAB,BARNALA,12137,12000,24137,35,54,123,0,0,12593,12450,25043,3,58,100,0,0
PUNJAB,BATHINDA,40000,11602,51602,14,442,0,7,0,12766,14565,27331,9,422,652,7,0
PUNJAB,FARIDKOT,6000,0,6000,0,410,0,1,0,1418,1168,2586,0,368,117,0,0
PUNJAB,FATEHGARH SAHIB,2485,16192,18677,0,363,0,2,0,2630,10895,13525,0,363,402,2,0
PUNJAB,FEROZEPUR,50655,75000,125655,0,326,604,10,0,12687,10690,23377,0,326,150,2,0
PUNJAB,GURDASPUR,40780,73530,114310,0,600,0,4,0,9304,4895,14199,0,110,56,3,0
PUNJAB,HOSHIARPUR,11112,0,11112,0,839,0,5,0,19094,209150,228244,0,1730,0,1,0
PUNJAB,JALANDHAR,19885,2708,22593,0,1200,0,5,0,19653,35252,54905,0,1200,256,2,0
PUNJAB,KAPURTHALA,12617,2229,14846,0,500,0,2,0,12095,9240,21335,0,627,155,1,0
PUNJAB,LUDHIANA,45422,8956,54378,50,156,311,10,0,46920,7230,54150,8,146,62,3,0
PUNJAB,MANSA,25000,44004,69004,75,240,391,10,0,23398,47180,70578,5,240,625,3,0
PUNJAB,MOGA,37170,0,37170,10,210,0,5,0,2261,2040,4301,6,333,353,2,0
PUNJAB,MUKTSAR,33148,0,33148,200,193,0,5,0,18000,6260,24260,45,195,0,2,0
PUNJAB,NAWANSHAHR,7273,35894,43167,0,330,0,2,0,11581,15760,27341,0,330,160,2,0
PUNJAB,PATIALA,60513,76029,136542,2,0,417,0,0,10227,14242,24469,7,0,417,0,0
PUNJAB,RUPNAGAR,28278,20872,49150,0,52,228,9,0,4212,28280,32492,0,72,522,2,0
PUNJAB,S.A.S NAGAR,4008,16674,20682,0,504,0,4,0,4025,6145,10170,0,104,303,2,0
PUNJAB,SANGRUR,19920,26006,45926,25,306,372,0,0,11909,22290,34199,16,358,90,0,0
PUNJAB,TARN TARAN,76706,55691,132397,0,140,450,0,0,14721,31275,45996,0,499,265,0,0
RAJASTHAN,AJMER,27392,184378,211770,50,2050,1157,10,0,24915,89571,114486,2,2654,920,7,3
RAJASTHAN,ALWAR,55920,284634,340554,50,3156,1610,10,0,41466,283864,325330,0,2498,890,13,13
RAJASTHAN,BANSWARA,169828,79429,249257,40,4092,1619,8,0,39769,44705,84474,1,4009,1116,0,0
RAJASTHAN,BARAN,45648,113170,158818,50,1269,1013,10,0,13418,78650,92068,29,1269,469,6,0
RAJASTHAN,BARMER,112891,171707,284598,60,4394,1980,10,0,79808,78762,158570,29,3926,895,8,8
RAJASTHAN,BHARATPUR,45606,199450,245056,50,794,586,10,0,7332,47887,55219,7,602,188,18,0
RAJASTHAN,BHILWARA,104663,174671,279334,50,4500,1519,10,0,64728,135832,200560,5,4500,714,32,0
RAJASTHAN,BIKANER,63295,120000,183295,85,2764,917,10,0,40790,74245,115035,66,2950,351,10,0
RAJASTHAN,BUNDI,41413,125545,166958,20,1898,296,10,0,28824,79688,108512,19,1898,284,5,0
RAJASTHAN,CHITTORGARH,56149,189366,245515,50,2800,1071,14,0,33968,128561,162529,50,2669,819,14,4
RAJASTHAN,CHURU,40000,101217,141217,42,1312,950,10,0,37907,99856,137763,13,1274,468,6,0
RAJASTHAN,DAUSA,43276,214288,257564,50,2073,954,10,0,14281,124094,138375,0,7681,158,9,0
RAJASTHAN,DHOLPUR,29882,100462,130344,50,1002,384,10,0,8309,66253,74562,1,1025,503,4,0
RAJASTHAN,DUNGARPUR,130459,37264,167723,50,3768,1481,10,0,107940,41000,148940,14,3383,1227,9,0
RAJASTHAN,GANGANAGAR,31756,134637,166393,20,3600,858,10,0,32342,112374,144716,6,3555,811,1,0
RAJASTHAN,HANUMANGARH,31621,35602,67223,50,1246,227,10,0,31621,35603,67224,11,1216,95,6,0
RAJASTHAN,JAIPUR,60791,315869,376660,50,7043,1108,10,0,20168,225330,245498,9,7021,1829,16,1
RAJASTHAN,JAISALMER,17497,61888,79385,56,2674,484,10,0,16549,39729,56278,52,2006,478,12,0
RAJASTHAN,JALOR,67713,133481,201194,50,3011,960,10,0,14730,76669,91399,0,2764,168,14,0
RAJASTHAN,JHALAWAR,55229,143234,198463,50,2452,1179,12,0,22190,37360,59550,24,2450,1065,5,0
RAJASTHAN,JHUNJHUNU,21440,177396,198836,50,1755,902,10,0,8146,186555,194701,29,1755,655,0,0
RAJASTHAN,JODHPUR,70837,248282,319119,50,4996,906,10,0,48878,211126,260004,34,2739,750,0,0
RAJASTHAN,KARAULI,68530,148819,217349,56,3969,672,10,0,45901,51940,97841,51,2883,541,5,0
RAJASTHAN,KOTA,47767,87135,134902,50,1510,1398,10,0,20152,33133,53285,5,1522,20,5,0
RAJASTHAN,NAGAUR,41537,256360,297897,50,2793,1855,10,0,41109,244781,285890,14,2793,761,11,0
RAJASTHAN,PALI,46444,228892,275336,50,1560,753,10,0,34076,178303,212379,11,1366,422,10,0
RAJASTHAN,RAJSAMAND,69568,121350,190918,35,2401,677,10,0,37635,69714,107349,35,2211,392,2,0
RAJASTHAN,SAWAI MADHOPUR,38914,137304,176218,50,1021,723,3,0,20797,56603,77400,3,1021,353,2,2
RAJASTHAN,SIKAR,28460,228307,256767,58,2962,659,10,0,23748,212107,235855,13,2987,123,0,0
RAJASTHAN,SIROHI,36060,79445,115505,50,1137,391,10,0,26023,59298,85321,20,1137,353,10,5
RAJASTHAN,TONK,41916,182977,224893,50,1812,724,10,0,15016,36688,51704,18,1564,274,0,10
RAJASTHAN,UDAIPUR,218401,206871,425272,22,3848,2256,10,0,111431,150422,261853,19,3819,1673,0,0
SIKKIM,EAST SIKKIM,24109,18000,42109,225,464,36,7,0,26852,18000,44852,271,464,87,0,0
SIKKIM,NORTH SIKKIM,4978,1031,6009,135,272,63,3,0,5461,1035,6496,147,272,88,0,0
SIKKIM,SOUTH SIKKIM,8970,7681,16651,205,438,82,1,0,12446,7929,20375,279,439,82,0,0
SIKKIM,WEST SIKKIM,13245,9000,22245,224,430,159,1,0,13345,9532,22877,216,431,159,0,0
TAMIL NADU,COIMBATORE,190006,163561,353567,10,1026,812,14,0,179517,164248,343765,10,1010,802,4,0
TAMIL NADU,CUDDALORE,242992,104369,347361,69,2635,1486,10,0,240101,102770,342871,23,2619,1486,10,13
TAMIL NADU,DHARMAPURI,152872,60203,213075,0,2507,715,4,0,152921,62320,215241,0,2379,715,1,0
TAMIL NADU,DINDIGUL,131516,319776,451292,20,1368,1374,10,0,113925,229998,343923,20,1307,1297,10,0
TAMIL NADU,ERODE,165306,110521,275827,63,2798,752,10,0,165306,144602,309908,63,2450,759,10,0
TAMIL NADU,KANCHIPURAM,147350,240767,388117,58,1955,1497,10,0,154480,156846,311326,51,1771,1495,8,7
TAMIL NADU,KANYAKUMARI(NAGERCOIL),76233,10568,86801,43,557,367,5,0,84822,7225,92047,21,429,384,2,0
TAMIL NADU,KARUR,105280,72598,177878,108,932,418,10,0,105280,54519,159799,98,678,419,10,6
TAMIL NADU,KRISHNAGIRI,204772,85863,290635,40,2774,924,6,0,154058,71306,225364,337,2559,866,6,0
TAMIL NADU,MADURAI,153151,224536,377687,0,1845,881,10,0,128212,111326,239538,444,1596,866,7,0
TAMIL NADU,NAGAPATTINAM,131000,140933,271933,50,1934,646,10,0,104227,85988,190215,1,1934,646,6,6
TAMIL NADU,NAMAKKAL,117538,113278,230816,50,1027,673,4,0,117538,72542,190080,50,1027,673,4,0
TAMIL NADU,NILGIRIS(UDHAGAMANDALAM),43000,51545,94545,75,839,271,4,0,34543,22403,56946,59,839,270,1,0
TAMIL NADU,PERAMBALUR,181496,94081,275577,49,1256,1185,10,0,181496,50785,232281,59,1237,932,11,4
TAMIL NADU,PUDUKKOTTAI,176710,77100,253810,50,3826,1306,10,0,198097,66346,264443,50,3548,1306,0,10
TAMIL NADU,RAMANATHAPURAM,105000,109870,214870,52,1460,821,10,0,156708,58018,214726,6,1460,821,5,0
TAMIL NADU,SALEM,232463,233736,466199,128,2108,1253,10,0,196762,130941,327703,32,2088,1185,4,1
TAMIL NADU,SIVAGANGA,125730,130058,255788,10,851,601,6,0,118647,52329,170976,12,851,601,9,0
TAMIL NADU,THANJAVUR,177761,196183,373944,25,4540,1022,10,0,136533,114750,251283,25,2565,962,2,0
TAMIL NADU,THENI,73362,71577,144939,35,440,552,7,0,71599,56590,128189,34,396,552,5,0
TAMIL NADU,THOOTHUKUDI,91637,253636,345273,54,260,718,4,0,84627,119850,204477,5,284,714,15,2
TAMIL NADU,TIRUCHIRAPPALLI,77747,166886,244633,5,929,1027,10,0,77747,124832,202579,5,774,869,10,0
TAMIL NADU,TIRUNELVELI,125763,155744,281507,19,557,907,10,0,139323,106744,246067,19,557,907,10,5
TAMIL NADU,TIRUVALLUR,194625,58084,252709,35,1418,1312,10,0,152779,80448,233227,35,1418,1312,8,0
TAMIL NADU,TIRUVANNAMALAI,209116,356665,565781,70,3635,1263,10,0,209116,289934,499050,43,3598,1263,4,0
TAMIL NADU,TIRUVARUR,80920,53866,134786,50,1698,519,5,0,87918,22048,109966,8,1466,519,1,1
TAMIL NADU,VELLORE,207635,283872,491507,26,3451,1667,10,0,200448,257974,458422,26,3167,1902,10,0
TAMIL NADU,VILLUPURAM,326185,211877,538062,60,3021,2185,10,0,265434,89384,354818,51,3021,2185,12,10
TAMIL NADU,VIRUDHUNAGAR,174967,93202,268169,184,2031,816,10,0,154435,126105,280540,165,1727,816,10,0
TRIPURA,DHALAI,53507,28305,81812,95,648,944,5,0,53507,27905,81412,110,1104,1261,84,6
TRIPURA,NORTH TRIPURA,78389,33744,112133,80,1150,1161,10,0,74981,31008,105989,76,1132,1136,48,44
TRIPURA,SOUTH TRIPURA,139456,55849,195305,38,1352,1858,10,0,139456,55849,195305,50,1352,2198,11,323
TRIPURA,WEST TRIPURA,183405,51119,234524,13,3683,2061,10,0,183405,44560,227965,13,2997,2061,0,59
UTTAR PRADESH,AGRA,54188,278943,333131,5,5274,2856,3,0,54789,241349,296138,5,4439,1774,7,3
UTTAR PRADESH,ALIGARH,73937,208775,282712,0,4007,1458,10,0,68096,170354,238450,0,3390,1458,3,1
UTTAR PRADESH,ALLAHABAD,181370,493671,675041,20,5829,2547,10,0,195345,274576,469921,35,6032,2547,9,0
UTTAR PRADESH,AMBEDKAR NAGAR,132725,138141,270866,18,2146,1350,3,1,132725,135470,268195,18,1710,1350,2,0
UTTAR PRADESH,AURAIYA,127279,133364,260643,50,1277,817,2,1,99555,112343,211898,50,2240,817,1,1
UTTAR PRADESH,AZAMGARH,188141,466925,655066,87,4888,4104,10,0,162413,249589,412002,87,4888,2744,6,0
UTTAR PRADESH,BAGPAT,31467,77930,109397,12,1166,954,1,1,26774,72482,99256,42,1196,1034,1,0
UTTAR PRADESH,BAHRAICH,284073,174857,458930,10,6100,1802,10,0,227057,170024,397081,10,5101,1802,1,0
UTTAR PRADESH,BALLIA,172179,136937,309116,115,4636,1888,10,0,167490,124522,292012,120,4636,1888,4,4
UTTAR PRADESH,BALRAMPUR,65273,138410,203683,18,2948,1215,3,0,65273,85019,150292,18,2948,1215,3,1
UTTAR PRADESH,BANDA,120620,78999,199619,10,4149,948,3,0,111499,60173,171672,10,3748,948,3,0
UTTAR PRADESH,BARABANKI,199542,377972,577514,26,5100,1798,10,0,206102,303001,509103,26,5100,1798,3,0
UTTAR PRADESH,BAREILLY,110000,227284,337284,15,4142,1798,5,0,110000,204725,314725,15,4142,1619,5,1
UTTAR PRADESH,BASTI,160480,120653,281133,40,3695,2223,10,0,130224,82934,213158,35,3695,2036,1,0
UTTAR PRADESH,BIJNOR,110403,222569,332972,75,5271,1399,10,0,110403,187491,297894,75,4294,1399,7,0
UTTAR PRADESH,BUDAUN,107603,204479,312082,155,4680,1615,0,0,107603,121933,229536,155,4680,1615,3,1
UTTAR PRADESH,BULANDSHAHR,28885,283408,312293,8,4868,2041,8,0,31996,223416,255412,8,4308,2041,1,0
UTTAR PRADESH,CHANDAULI,92022,108852,200874,25,2287,1102,10,0,96318,86107,182425,25,2287,1102,10,0
UTTAR PRADESH,CHITRAKOOT,38082,102505,140587,0,1920,479,5,0,42652,63535,106187,0,1920,479,1,0
UTTAR PRADESH,DEORIA,181225,198893,380118,39,4696,1461,10,0,172252,170551,342803,31,4696,1461,2,0
UTTAR PRADESH,ETAH,62001,143740,205741,30,3455,1347,7,1,69140,111863,181003,30,5220,1796,2,0
UTTAR PRADESH,ETAWAH,94097,223387,317484,44,2925,1223,3,1,94097,155801,249898,44,2925,1223,4,0
UTTAR PRADESH,FAIZABAD,103376,105998,209374,10,2085,1140,10,0,101884,94917,196801,10,2085,1140,8,0
UTTAR PRADESH,FARRUKHABAD,120471,54314,174785,35,3143,1227,2,1,120471,54314,174785,35,3143,1227,3,0
UTTAR PRADESH,FATEHPUR,104414,202040,306454,15,3938,1548,5,0,99961,135418,235379,15,3938,1548,5,0
UTTAR PRADESH,FIROZABAD,19843,228195,248038,10,3232,963,3,1,19843,161798,181641,10,3232,963,0,0
UTTAR PRADESH,GAUTAM BUDDHA NAGAR,14574,58357,72931,15,1414,716,1,1,14302,53142,67444,15,1582,716,0,0
UTTAR PRADESH,GHAZIABAD,10810,85267,96077,5,3602,1075,5,0,10810,83380,94190,5,1946,1075,2,0
UTTAR PRADESH,GHAZIPUR,184061,288972,473033,100,3878,1517,10,0,183147,153425,336572,100,3878,1517,10,2
UTTAR PRADESH,GONDA,136500,198080,334580,16,4298,2031,6,2,118936,141932,260868,16,4298,1574,4,2
UTTAR PRADESH,GORAKHPUR,211033,280101,491134,121,6036,1823,10,0,211010,202482,413492,121,4877,1823,3,0
UTTAR PRADESH,HAMIRPUR,101382,75310,176692,0,1950,707,4,0,85181,50767,135948,0,1950,707,4,0
UTTAR PRADESH,HARDOI,199989,231215,431204,5,8478,1978,10,0,199989,212685,412674,5,5627,1978,10,5
UTTAR PRADESH,JALAUN,101928,71232,173160,20,2686,873,12,0,90940,57528,148468,20,2700,873,6,0
UTTAR PRADESH,JAUNPUR,250000,444693,694693,138,7179,3897,10,0,251456,343075,594531,138,5575,3897,8,8
UTTAR PRADESH,JHANSI,58826,78506,137332,20,2808,912,6,0,59272,53974,113246,20,2808,912,6,3
UTTAR PRADESH,JYOTIBA PHULE NAGAR,48008,113276,161284,0,2389,1032,0,0,48008,105068,153076,0,2290,1032,2,1
UTTAR PRADESH,KANNAUJ,101497,280737,382234,46,2388,1440,6,1,102321,201515,303836,46,2373,1440,2,1
UTTAR PRADESH,KANPUR DEHAT,126650,117438,244088,60,3536,1149,10,0,121873,87510,209383,60,3536,1149,5,5
UTTAR PRADESH,KANPUR NAGAR,87235,128893,216128,50,3763,1806,10,0,81772,112914,194686,50,3310,1784,5,0
UTTAR PRADESH,KANSHIRAM NAGAR,49298,91499,140797,14,2777,989,7,0,18037,13001,31038,0,2777,989,0,0
UTTAR PRADESH,KAUSHAMBI,127875,147350,275225,24,2048,968,3,1,123820,85976,209796,24,2048,785,3,0
UTTAR PRADESH,KUSHINAGAR,287089,160033,447122,25,5120,2133,3,0,236062,146654,382716,25,4168,2133,1,0
UTTAR PRADESH,LAKHIMPUR KHERI,73000,124463,197463,20,8355,1930,10,0,96730,124463,221193,20,5144,1930,5,0
UTTAR PRADESH,LALITPUR,90107,47239,137346,6,2468,568,2,0,89046,38393,127439,6,2468,568,0,0
UTTAR PRADESH,LUCKNOW,113188,137908,251096,25,2510,1591,10,0,113188,112396,225584,25,3121,1273,10,10
UTTAR PRADESH,MAHAMAYA NAGAR(HATHRAS),25153,129568,154721,10,2423,1130,3,1,25277,114597,139874,10,2146,1130,1,0
UTTAR PRADESH,MAHARAJGANJ,145090,111256,256346,55,2956,1461,5,1,145090,90842,235932,55,2956,1461,4,0
UTTAR PRADESH,MAHOBA,53117,70666,123783,0,2153,464,1,1,53267,65714,118981,0,1756,464,2,0
UTTAR PRADESH,MAINPURI,84258,121244,205502,10,3334,1309,3,1,77399,98278,175677,10,3334,1309,4,0
UTTAR PRADESH,MATHURA,25005,182330,207335,10,3228,1475,3,1,25593,130508,156101,10,2936,979,1,0
UTTAR PRADESH,MAU,133766,73752,207518,13,2494,1090,5,0,108577,59123,167700,13,2494,1090,5,3
UTTAR PRADESH,MEERUT,25514,119754,145268,25,2418,1310,6,3,25357,114465,139822,25,2222,907,3,3
UTTAR PRADESH,MIRZAPUR,231315,195266,426581,133,3941,1582,10,0,234252,183427,417679,133,3941,1582,10,10
UTTAR PRADESH,MORADABAD,76018,354539,430557,0,8504,2641,4,1,76018,275460,351478,0,4870,2095,2,1
UTTAR PRADESH,MUZAFFARNAGAR,51660,238443,290103,14,3700,2074,2,0,51660,169008,220668,14,3478,2074,2,0
UTTAR PRADESH,PILIBHIT,95178,119893,215071,21,2786,889,2,1,95178,103271,198449,21,2786,889,1,1
UTTAR PRADESH,PRATAPGARH,141368,264341,405709,50,2525,1955,10,0,144927,167186,312113,79,2525,2030,3,0
UTTAR PRADESH,RAE BARELI,190306,135862,326168,25,5809,1860,5,0,192190,124312,316502,25,4188,1860,1,0
UTTAR PRADESH,RAMPUR,56948,150145,207093,0,4382,1385,2,1,52635,149209,201844,0,2195,1275,1,1
UTTAR PRADESH,SAHARANPUR,49458,192771,242229,25,3766,1720,11,0,49701,190364,240065,25,3505,1299,4,0
UTTAR PRADESH,SANT KABIR NAGAR,121112,227284,348396,35,2368,991,4,0,93881,104716,198597,35,2368,991,3,0
UTTAR PRADESH,SANT RAVIDAS NAGAR( BHADOHI),75119,103247,178366,43,2083,1233,5,0,69904,85676,155580,43,1602,1233,1,0
UTTAR PRADESH,SHAHJAHANPUR,194645,114246,308891,10,4842,1347,0,0,194959,94352,289311,10,4842,1347,6,9
UTTAR PRADESH,SHRAVASTI,104902,54772,159674,10,1838,650,3,0,99254,41818,141072,10,1838,650,0,0
UTTAR PRADESH,SIDDHARTHNAGAR,139597,133650,273247,50,4128,1481,5,0,124597,111651,236248,50,4128,1481,2,0
UTTAR PRADESH,SITAPUR,305299,255574,560873,25,7397,2307,3,1,274354,185138,459492,25,5874,2307,1,1
UTTAR PRADESH,SONBHADRA,138370,79419,217789,113,3176,1051,0,0,138370,57900,196270,113,3006,767,10,0
UTTAR PRADESH,SULTANPUR,168843,262071,430914,40,4898,2244,6,0,168843,215646,384489,40,4898,2244,6,0
UTTAR PRADESH,UNNAO,229599,141734,371333,20,4700,1683,8,0,223787,132308,356095,20,4700,1683,2,2
UTTAR PRADESH,VARANASI,105408,249056,354464,47,4471,1532,0,0,102430,147532,249962,47,2516,1283,3,0
UTTARAKHAND,ALMORA,45572,48151,93723,40,214,247,10,0,32789,38884,71673,30,239,4,0,0
UTTARAKHAND,BAGESHWAR,21447,16508,37955,20,111,149,3,0,18036,18883,36919,6,105,2,2,0
UTTARAKHAND,CHAMOLI,27147,26145,53292,10,265,115,7,2,26310,26512,52822,0,222,7,3,0
UTTARAKHAND,CHAMPAWAT,22991,9085,32076,20,375,78,2,1,18498,14678,33176,3,160,6,1,0
UTTARAKHAND,DEHRADUN,37212,24463,61675,0,497,19,5,1,32474,24914,57388,0,396,19,1,0
UTTARAKHAND,HARIDWAR,42500,90074,132574,60,200,20,2,0,38644,78609,117253,37,100,13,0,0,
UTTARAKHAND,NAINITAL,14314,26585,40899,50,208,95,6,2,18039,29703,47742,1,208,19,2,0
UTTARAKHAND,PAURI(GARHWAL),53399,37146,90545,50,620,173,10,0,36814,43505,80319,8,367,23,3,0
UTTARAKHAND,PITHORAGARH,41110,29253,70363,50,670,215,6,2,34876,32098,66974,10,439,102,3,0
UTTARAKHAND,RUDRAPRAYAG,13150,22322,35472,40,100,124,3,0,14055,17566,31621,9,100,70,2,0
UTTARAKHAND,TEHRI GARHWAL,55173,34580,89753,30,307,120,8,0,46608,35264,81872,0,493,10,0,0
UTTARAKHAND,UDHAM SINGH NAGAR,39427,59658,99085,50,118,123,5,2,37764,52505,90269,0,119,75,4,1
UTTARAKHAND,UTTARKASHI,28189,20700,48889,50,240,123,4,0,25601,21146,46747,4,240,0,3,0
WEST BENGAL,BANKURA,198152,333832,531984,50,7544,4130,29,0,107239,243933,351172,62,7734,1394,26,0
WEST BENGAL,BARDHAMAN,700047,341920,1041967,133,9891,7980,10,0,607788,278429,886217,140,9890,7724,10,19
WEST BENGAL,BIRBHUM,338989,299893,638882,50,5617,3816,4,22,275112,188995,464107,58,5636,2409,19,0
WEST BENGAL,COOCH BEHAR,335236,254422,589658,50,3715,1718,15,0,265576,166510,432086,144,5764,1818,15,12
WEST BENGAL,DAKSHIN DINAJPUR,182621,194577,377198,50,3712,2642,10,0,186144,53164,239308,20,2682,1003,8,8
WEST BENGAL,DARJEELING,66648,130066,196714,50,1784,408,0,0,33939,3035,36974,18,1443,574,8,8
WEST BENGAL,HOOGHLY,271737,195510,467247,53,6821,4168,19,0,270873,191294,462167,50,6764,3435,18,18
WEST BENGAL,HOWRAH,231860,143309,375169,51,5195,3586,26,0,230196,141912,372108,42,5353,2781,14,20
WEST BENGAL,JALPAIGURI,372999,203523,576522,50,6578,5428,87,0,342324,106168,448492,25,6578,4064,17,14
WEST BENGAL,MALDA,452324,270208,722532,50,6385,7956,6,0,328065,67187,395252,41,6047,464,15,15
WEST BENGAL,MIDNAPUR EAST,392371,32617,424988,172,9726,5969,25,0,527389,32642,560031,210,10149,2882,8,17
WEST BENGAL,MIDNAPUR WEST,509496,432096,941592,50,16498,5825,10,0,596291,323558,919849,73,13693,2838,0,0
WEST BENGAL,MURSHIDABAD,702442,506963,1209405,50,10260,7012,18,0,504029,198222,702251,49,8102,2640,26,26
WEST BENGAL,NADIA,346696,278335,625031,50,6974,6620,50,0,321780,198956,520736,30,6798,3996,23,41
WEST BENGAL,NORTH 24 PARAGANAS,361462,225080,586542,51,11158,4466,30,0,359532,226104,585636,67,11039,3247,101,0
WEST BENGAL,PURULIA,210168,306933,517101,50,7542,4047,10,0,102306,83269,185575,10,4853,1239,20,0
WEST BENGAL,SILIGURI,59536,25377,84913,30,935,1393,0,10,38224,18537,56761,30,929,922,5,7
WEST BENGAL,SOUTH 24 PARAGANAS,628712,521192,1149904,50,8940,5448,30,0,601989,162578,764567,31,7499,1690,29,29
WEST BENGAL,UTTAR DINAJPUR,257662,301645,559307,50,4806,1556,30,0,149439,185451,334890,30,2562,2041,17,0
30-Jul-2013,30-Jul-2013,30-Jul-2013,30-Jul-2013,30-Jul-2013,30-Jul-2013,30-Jul-2013,30-Jul-2013,30-Jul-2013,30-Jul-2013